Category:	YouTube
":yt:"	"yt" 
":oops:"	"oops" 
":buffering:"	"buffering" 
":stayhome:"	"stayhome" 
":dothefive:"	"dothefive" 
":elbowbump:"	"elbowbump" 
":goodvibes:"	"goodvibes" 
":thanksdoc:"	"thanksdoc" 
":videocall:"	"videocall" 
":virtualhug:"	"virtualhug" 
":yougotthis:"	"yougotthis" 
":sanitizer:"	"sanitizer" 
":takeout:"	"takeout" 
":hydrate:"	"hydrate" 
":chillwcat:"	"chillwcat" 
":chillwdog:"	"chillwdog" 
":elbowcough:"	"elbowcough" 
":learning:"	"learning" 
":washhands:"	"washhands" 
":socialdist:"	"socialdist" 
":shelterin:"	"shelterin" 

Category:	People
":grinning_face:"	"ğŸ˜€" 
":grinning_face_with_big_eyes:"	"ğŸ˜ƒ" 
":grinning_face_with_smiling_eyes:"	"ğŸ˜„" 
":beaming_face_with_smiling_eyes:"	"ğŸ˜" 
":grinning_squinting_face:"	"ğŸ˜†" 
":grinning_face_with_sweat:"	"ğŸ˜…" 
":rolling_on_the_floor_laughing:"	"ğŸ¤£" 
":face_with_tears_of_joy:"	"ğŸ˜‚" 
":slightly_smiling_face:"	"ğŸ™‚" 
":upside_down_face:"	"ğŸ™ƒ" 
":winking_face:"	"ğŸ˜‰" 
":smiling_face_with_smiling_eyes:"	"ğŸ˜Š" 
":smiling_face_with_halo:"	"ğŸ˜‡" 
":smiling_face_with_hearts:"	"ğŸ¥°" 
":smiling_face_with_heart_eyes:"	"ğŸ˜" 
":star_struck:"	"ğŸ¤©" 
":face_blowing_a_kiss:"	"ğŸ˜˜" 
":kissing_face:"	"ğŸ˜—" 
":smiling_face:"	"â˜º" 
":kissing_face_with_closed_eyes:"	"ğŸ˜š" 
":kissing_face_with_smiling_eyes:"	"ğŸ˜™" 
":smiling_face_with_tear:"	"ğŸ¥²" 
":face_savoring_food:"	"ğŸ˜‹" 
":face_with_tongue:"	"ğŸ˜›" 
":winking_face_with_tongue:"	"ğŸ˜œ" 
":zany_face:"	"ğŸ¤ª" 
":squinting_face_with_tongue:"	"ğŸ˜" 
":money_mouth_face:"	"ğŸ¤‘" 
":hugging_face:"	"ğŸ¤—" 
":face_with_hand_over_mouth:"	"ğŸ¤­" 
":shushing_face:"	"ğŸ¤«" 
":thinking_face:"	"ğŸ¤”" 
":zipper_mouth_face:"	"ğŸ¤" 
":face_with_raised_eyebrow:"	"ğŸ¤¨" 
":neutral_face:"	"ğŸ˜" 
":expressionless_face:"	"ğŸ˜‘" 
":face_without_mouth:"	"ğŸ˜¶" 
":face_in_clouds:"	"ğŸ˜¶â€ğŸŒ«" 
":smirking_face:"	"ğŸ˜" 
":unamused_face:"	"ğŸ˜’" 
":face_with_rolling_eyes:"	"ğŸ™„" 
":grimacing_face:"	"ğŸ˜¬" 
":face_exhaling:"	"ğŸ˜®â€ğŸ’¨" 
":lying_face:"	"ğŸ¤¥" 
":relieved_face:"	"ğŸ˜Œ" 
":pensive_face:"	"ğŸ˜”" 
":sleepy_face:"	"ğŸ˜ª" 
":drooling_face:"	"ğŸ¤¤" 
":sleeping_face:"	"ğŸ˜´" 
":face_with_medical_mask:"	"ğŸ˜·" 
":face_with_thermometer:"	"ğŸ¤’" 
":face_with_head_bandage:"	"ğŸ¤•" 
":nauseated_face:"	"ğŸ¤¢" 
":face_vomiting:"	"ğŸ¤®" 
":sneezing_face:"	"ğŸ¤§" 
":hot_face:"	"ğŸ¥µ" 
":cold_face:"	"ğŸ¥¶" 
":woozy_face:"	"ğŸ¥´" 
":knocked_out_face:"	"ğŸ˜µ" 
":face_with_spiral_eyes:"	"ğŸ˜µâ€ğŸ’«" 
":exploding_head:"	"ğŸ¤¯" 
":cowboy_hat_face:"	"ğŸ¤ " 
":partying_face:"	"ğŸ¥³" 
":disguised_face:"	"ğŸ¥¸" 
":smiling_face_with_sunglasses:"	"ğŸ˜" 
":nerd_face:"	"ğŸ¤“" 
":face_with_monocle:"	"ğŸ§" 
":confused_face:"	"ğŸ˜•" 
":worried_face:"	"ğŸ˜Ÿ" 
":slightly_frowning_face:"	"ğŸ™" 
":frowning_face:"	"â˜¹" 
":face_with_open_mouth:"	"ğŸ˜®" 
":hushed_face:"	"ğŸ˜¯" 
":astonished_face:"	"ğŸ˜²" 
":flushed_face:"	"ğŸ˜³" 
":pleading_face:"	"ğŸ¥º" 
":frowning_face_with_open_mouth:"	"ğŸ˜¦" 
":anguished_face:"	"ğŸ˜§" 
":fearful_face:"	"ğŸ˜¨" 
":anxious_face_with_sweat:"	"ğŸ˜°" 
":sad_but_relieved_face:"	"ğŸ˜¥" 
":crying_face:"	"ğŸ˜¢" 
":loudly_crying_face:"	"ğŸ˜­" 
":face_screaming_in_fear:"	"ğŸ˜±" 
":confounded_face:"	"ğŸ˜–" 
":persevering_face:"	"ğŸ˜£" 
":disappointed_face:"	"ğŸ˜" 
":downcast_face_with_sweat:"	"ğŸ˜“" 
":weary_face:"	"ğŸ˜©" 
":tired_face:"	"ğŸ˜«" 
":yawning_face:"	"ğŸ¥±" 
":face_with_steam_from_nose:"	"ğŸ˜¤" 
":pouting_face:"	"ğŸ˜¡" 
":angry_face:"	"ğŸ˜ " 
":face_with_symbols_on_mouth:"	"ğŸ¤¬" 
":smiling_face_with_horns:"	"ğŸ˜ˆ" 
":angry_face_with_horns:"	"ğŸ‘¿" 
":skull:"	"ğŸ’€" 
":skull_and_crossbones:"	"â˜ " 
":pile_of_poo:"	"ğŸ’©" 
":clown_face:"	"ğŸ¤¡" 
":ogre:"	"ğŸ‘¹" 
":goblin:"	"ğŸ‘º" 
":ghost:"	"ğŸ‘»" 
":alien:"	"ğŸ‘½" 
":alien_monster:"	"ğŸ‘¾" 
":robot:"	"ğŸ¤–" 
":grinning_cat:"	"ğŸ˜º" 
":grinning_cat_with_smiling_eyes:"	"ğŸ˜¸" 
":cat_with_tears_of_joy:"	"ğŸ˜¹" 
":smiling_cat_with_heart_eyes:"	"ğŸ˜»" 
":cat_with_wry_smile:"	"ğŸ˜¼" 
":kissing_cat:"	"ğŸ˜½" 
":weary_cat:"	"ğŸ™€" 
":crying_cat:"	"ğŸ˜¿" 
":pouting_cat:"	"ğŸ˜¾" 
":see_no_evil_monkey:"	"ğŸ™ˆ" 
":hear_no_evil_monkey:"	"ğŸ™‰" 
":speak_no_evil_monkey:"	"ğŸ™Š" 
":kiss:"	"ğŸ’‹" 
":love_letter:"	"ğŸ’Œ" 
":heart_with_arrow:"	"ğŸ’˜" 
":heart_with_ribbon:"	"ğŸ’" 
":sparkling_heart:"	"ğŸ’–" 
":growing_heart:"	"ğŸ’—" 
":beating_heart:"	"ğŸ’“" 
":revolving_hearts:"	"ğŸ’" 
":two_hearts:"	"ğŸ’•" 
":heart_decoration:"	"ğŸ’Ÿ" 
":heart_exclamation:"	"â£" 
":broken_heart:"	"ğŸ’”" 
":heart_on_fire:"	"â¤â€ğŸ”¥" 
":mending_heart:"	"â¤â€ğŸ©¹" 
":red_heart:"	"â¤" 
":orange_heart:"	"ğŸ§¡" 
":yellow_heart:"	"ğŸ’›" 
":green_heart:"	"ğŸ’š" 
":blue_heart:"	"ğŸ’™" 
":purple_heart:"	"ğŸ’œ" 
":brown_heart:"	"ğŸ¤" 
":black_heart:"	"ğŸ–¤" 
":white_heart:"	"ğŸ¤" 
":hundred_points:"	"ğŸ’¯" 
":anger_symbol:"	"ğŸ’¢" 
":collision:"	"ğŸ’¥" 
":dizzy:"	"ğŸ’«" 
":sweat_droplets:"	"ğŸ’¦" 
":dashing_away:"	"ğŸ’¨" 
":hole:"	"ğŸ•³" 
":bomb:"	"ğŸ’£" 
":speech_balloon:"	"ğŸ’¬" 
":eye_in_speech_bubble:"	"ğŸ‘â€ğŸ—¨" 
":left_speech_bubble:"	"ğŸ—¨" 
":right_anger_bubble:"	"ğŸ—¯" 
":thought_balloon:"	"ğŸ’­" 
":zzz:"	"ğŸ’¤" 
":waving_hand:"	"ğŸ‘‹" 
":raised_back_of_hand:"	"ğŸ¤š" 
":hand_with_fingers_splayed:"	"ğŸ–" 
":raised_hand:"	"âœ‹" 
":vulcan_salute:"	"ğŸ––" 
":ok_hand:"	"ğŸ‘Œ" 
":pinched_fingers:"	"ğŸ¤Œ" 
":pinching_hand:"	"ğŸ¤" 
":victory_hand:"	"âœŒ" 
":crossed_fingers:"	"ğŸ¤" 
":love_you_gesture:"	"ğŸ¤Ÿ" 
":sign_of_the_horns:"	"ğŸ¤˜" 
":call_me_hand:"	"ğŸ¤™" 
":backhand_index_pointing_left:"	"ğŸ‘ˆ" 
":backhand_index_pointing_right:"	"ğŸ‘‰" 
":backhand_index_pointing_up:"	"ğŸ‘†" 
":middle_finger:"	"ğŸ–•" 
":backhand_index_pointing_down:"	"ğŸ‘‡" 
":index_pointing_up:"	"â˜" 
":thumbs_up:"	"ğŸ‘" 
":thumbs_down:"	"ğŸ‘" 
":raised_fist:"	"âœŠ" 
":oncoming_fist:"	"ğŸ‘Š" 
":left_facing_fist:"	"ğŸ¤›" 
":right_facing_fist:"	"ğŸ¤œ" 
":clapping_hands:"	"ğŸ‘" 
":raising_hands:"	"ğŸ™Œ" 
":open_hands:"	"ğŸ‘" 
":palms_up_together:"	"ğŸ¤²" 
":handshake:"	"ğŸ¤" 
":folded_hands:"	"ğŸ™" 
":writing_hand:"	"âœ" 
":nail_polish:"	"ğŸ’…" 
":selfie:"	"ğŸ¤³" 
":flexed_biceps:"	"ğŸ’ª" 
":mechanical_arm:"	"ğŸ¦¾" 
":mechanical_leg:"	"ğŸ¦¿" 
":leg:"	"ğŸ¦µ" 
":foot:"	"ğŸ¦¶" 
":ear:"	"ğŸ‘‚" 
":ear_with_hearing_aid:"	"ğŸ¦»" 
":nose:"	"ğŸ‘ƒ" 
":brain:"	"ğŸ§ " 
":anatomical_heart:"	"ğŸ«€" 
":lungs:"	"ğŸ«" 
":tooth:"	"ğŸ¦·" 
":bone:"	"ğŸ¦´" 
":eyes:"	"ğŸ‘€" 
":eye:"	"ğŸ‘" 
":tongue:"	"ğŸ‘…" 
":mouth:"	"ğŸ‘„" 
":baby:"	"ğŸ‘¶" 
":child:"	"ğŸ§’" 
":boy:"	"ğŸ‘¦" 
":girl:"	"ğŸ‘§" 
":person:"	"ğŸ§‘" 
":person_blond_hair:"	"ğŸ‘±" 
":man:"	"ğŸ‘¨" 
":person_beard:"	"ğŸ§”" 
":man_beard:"	"ğŸ§”â€â™‚" 
":woman_beard:"	"ğŸ§”â€â™€" 
":woman:"	"ğŸ‘©" 
":woman_blond_hair:"	"ğŸ‘±â€â™€" 
":man_blond_hair:"	"ğŸ‘±â€â™‚" 
":older_person:"	"ğŸ§“" 
":old_man:"	"ğŸ‘´" 
":old_woman:"	"ğŸ‘µ" 
":person_frowning:"	"ğŸ™" 
":man_frowning:"	"ğŸ™â€â™‚" 
":woman_frowning:"	"ğŸ™â€â™€" 
":person_pouting:"	"ğŸ™" 
":man_pouting:"	"ğŸ™â€â™‚" 
":woman_pouting:"	"ğŸ™â€â™€" 
":person_gesturing_no:"	"ğŸ™…" 
":man_gesturing_no:"	"ğŸ™…â€â™‚" 
":woman_gesturing_no:"	"ğŸ™…â€â™€" 
":person_gesturing_ok:"	"ğŸ™†" 
":man_gesturing_ok:"	"ğŸ™†â€â™‚" 
":woman_gesturing_ok:"	"ğŸ™†â€â™€" 
":person_tipping_hand:"	"ğŸ’" 
":man_tipping_hand:"	"ğŸ’â€â™‚" 
":woman_tipping_hand:"	"ğŸ’â€â™€" 
":person_raising_hand:"	"ğŸ™‹" 
":man_raising_hand:"	"ğŸ™‹â€â™‚" 
":woman_raising_hand:"	"ğŸ™‹â€â™€" 
":deaf_person:"	"ğŸ§" 
":deaf_man:"	"ğŸ§â€â™‚" 
":deaf_woman:"	"ğŸ§â€â™€" 
":person_bowing:"	"ğŸ™‡" 
":man_bowing:"	"ğŸ™‡â€â™‚" 
":woman_bowing:"	"ğŸ™‡â€â™€" 
":person_facepalming:"	"ğŸ¤¦" 
":man_facepalming:"	"ğŸ¤¦â€â™‚" 
":woman_facepalming:"	"ğŸ¤¦â€â™€" 
":person_shrugging:"	"ğŸ¤·" 
":man_shrugging:"	"ğŸ¤·â€â™‚" 
":woman_shrugging:"	"ğŸ¤·â€â™€" 
":health_worker:"	"ğŸ§‘â€âš•" 
":man_health_worker:"	"ğŸ‘¨â€âš•" 
":woman_health_worker:"	"ğŸ‘©â€âš•" 
":student:"	"ğŸ§‘â€ğŸ“" 
":man_student:"	"ğŸ‘¨â€ğŸ“" 
":woman_student:"	"ğŸ‘©â€ğŸ“" 
":teacher:"	"ğŸ§‘â€ğŸ«" 
":man_teacher:"	"ğŸ‘¨â€ğŸ«" 
":woman_teacher:"	"ğŸ‘©â€ğŸ«" 
":judge:"	"ğŸ§‘â€âš–" 
":man_judge:"	"ğŸ‘¨â€âš–" 
":woman_judge:"	"ğŸ‘©â€âš–" 
":farmer:"	"ğŸ§‘â€ğŸŒ¾" 
":man_farmer:"	"ğŸ‘¨â€ğŸŒ¾" 
":woman_farmer:"	"ğŸ‘©â€ğŸŒ¾" 
":cook:"	"ğŸ§‘â€ğŸ³" 
":man_cook:"	"ğŸ‘¨â€ğŸ³" 
":woman_cook:"	"ğŸ‘©â€ğŸ³" 
":mechanic:"	"ğŸ§‘â€ğŸ”§" 
":man_mechanic:"	"ğŸ‘¨â€ğŸ”§" 
":woman_mechanic:"	"ğŸ‘©â€ğŸ”§" 
":factory_worker:"	"ğŸ§‘â€ğŸ­" 
":man_factory_worker:"	"ğŸ‘¨â€ğŸ­" 
":woman_factory_worker:"	"ğŸ‘©â€ğŸ­" 
":office_worker:"	"ğŸ§‘â€ğŸ’¼" 
":man_office_worker:"	"ğŸ‘¨â€ğŸ’¼" 
":woman_office_worker:"	"ğŸ‘©â€ğŸ’¼" 
":scientist:"	"ğŸ§‘â€ğŸ”¬" 
":man_scientist:"	"ğŸ‘¨â€ğŸ”¬" 
":woman_scientist:"	"ğŸ‘©â€ğŸ”¬" 
":technologist:"	"ğŸ§‘â€ğŸ’»" 
":man_technologist:"	"ğŸ‘¨â€ğŸ’»" 
":woman_technologist:"	"ğŸ‘©â€ğŸ’»" 
":singer:"	"ğŸ§‘â€ğŸ¤" 
":man_singer:"	"ğŸ‘¨â€ğŸ¤" 
":woman_singer:"	"ğŸ‘©â€ğŸ¤" 
":artist:"	"ğŸ§‘â€ğŸ¨" 
":man_artist:"	"ğŸ‘¨â€ğŸ¨" 
":woman_artist:"	"ğŸ‘©â€ğŸ¨" 
":pilot:"	"ğŸ§‘â€âœˆ" 
":man_pilot:"	"ğŸ‘¨â€âœˆ" 
":woman_pilot:"	"ğŸ‘©â€âœˆ" 
":astronaut:"	"ğŸ§‘â€ğŸš€" 
":man_astronaut:"	"ğŸ‘¨â€ğŸš€" 
":woman_astronaut:"	"ğŸ‘©â€ğŸš€" 
":firefighter:"	"ğŸ§‘â€ğŸš’" 
":man_firefighter:"	"ğŸ‘¨â€ğŸš’" 
":woman_firefighter:"	"ğŸ‘©â€ğŸš’" 
":police_officer:"	"ğŸ‘®" 
":man_police_officer:"	"ğŸ‘®â€â™‚" 
":woman_police_officer:"	"ğŸ‘®â€â™€" 
":detective:"	"ğŸ•µ" 
":man_detective:"	"ğŸ•µâ€â™‚" 
":woman_detective:"	"ğŸ•µâ€â™€" 
":guard:"	"ğŸ’‚" 
":man_guard:"	"ğŸ’‚â€â™‚" 
":woman_guard:"	"ğŸ’‚â€â™€" 
":ninja:"	"ğŸ¥·" 
":construction_worker:"	"ğŸ‘·" 
":man_construction_worker:"	"ğŸ‘·â€â™‚" 
":woman_construction_worker:"	"ğŸ‘·â€â™€" 
":prince:"	"ğŸ¤´" 
":princess:"	"ğŸ‘¸" 
":person_wearing_turban:"	"ğŸ‘³" 
":man_wearing_turban:"	"ğŸ‘³â€â™‚" 
":woman_wearing_turban:"	"ğŸ‘³â€â™€" 
":person_with_skullcap:"	"ğŸ‘²" 
":woman_with_headscarf:"	"ğŸ§•" 
":person_in_tuxedo:"	"ğŸ¤µ" 
":man_in_tuxedo:"	"ğŸ¤µâ€â™‚" 
":woman_in_tuxedo:"	"ğŸ¤µâ€â™€" 
":person_with_veil:"	"ğŸ‘°" 
":man_with_veil:"	"ğŸ‘°â€â™‚" 
":woman_with_veil:"	"ğŸ‘°â€â™€" 
":pregnant_woman:"	"ğŸ¤°" 
":breast_feeding:"	"ğŸ¤±" 
":woman_feeding_baby:"	"ğŸ‘©â€ğŸ¼" 
":man_feeding_baby:"	"ğŸ‘¨â€ğŸ¼" 
":person_feeding_baby:"	"ğŸ§‘â€ğŸ¼" 
":baby_angel:"	"ğŸ‘¼" 
":santa_claus:"	"ğŸ…" 
":mrs_claus:"	"ğŸ¤¶" 
":mx_claus:"	"ğŸ§‘â€ğŸ„" 
":superhero:"	"ğŸ¦¸" 
":man_superhero:"	"ğŸ¦¸â€â™‚" 
":woman_superhero:"	"ğŸ¦¸â€â™€" 
":supervillain:"	"ğŸ¦¹" 
":man_supervillain:"	"ğŸ¦¹â€â™‚" 
":woman_supervillain:"	"ğŸ¦¹â€â™€" 
":mage:"	"ğŸ§™" 
":man_mage:"	"ğŸ§™â€â™‚" 
":woman_mage:"	"ğŸ§™â€â™€" 
":fairy:"	"ğŸ§š" 
":man_fairy:"	"ğŸ§šâ€â™‚" 
":woman_fairy:"	"ğŸ§šâ€â™€" 
":vampire:"	"ğŸ§›" 
":man_vampire:"	"ğŸ§›â€â™‚" 
":woman_vampire:"	"ğŸ§›â€â™€" 
":merperson:"	"ğŸ§œ" 
":merman:"	"ğŸ§œâ€â™‚" 
":mermaid:"	"ğŸ§œâ€â™€" 
":elf:"	"ğŸ§" 
":man_elf:"	"ğŸ§â€â™‚" 
":woman_elf:"	"ğŸ§â€â™€" 
":genie:"	"ğŸ§" 
":man_genie:"	"ğŸ§â€â™‚" 
":woman_genie:"	"ğŸ§â€â™€" 
":zombie:"	"ğŸ§Ÿ" 
":man_zombie:"	"ğŸ§Ÿâ€â™‚" 
":woman_zombie:"	"ğŸ§Ÿâ€â™€" 
":person_getting_massage:"	"ğŸ’†" 
":man_getting_massage:"	"ğŸ’†â€â™‚" 
":woman_getting_massage:"	"ğŸ’†â€â™€" 
":person_getting_haircut:"	"ğŸ’‡" 
":man_getting_haircut:"	"ğŸ’‡â€â™‚" 
":woman_getting_haircut:"	"ğŸ’‡â€â™€" 
":person_walking:"	"ğŸš¶" 
":man_walking:"	"ğŸš¶â€â™‚" 
":woman_walking:"	"ğŸš¶â€â™€" 
":person_standing:"	"ğŸ§" 
":man_standing:"	"ğŸ§â€â™‚" 
":woman_standing:"	"ğŸ§â€â™€" 
":person_kneeling:"	"ğŸ§" 
":man_kneeling:"	"ğŸ§â€â™‚" 
":woman_kneeling:"	"ğŸ§â€â™€" 
":person_with_white_cane:"	"ğŸ§‘â€ğŸ¦¯" 
":man_with_white_cane:"	"ğŸ‘¨â€ğŸ¦¯" 
":woman_with_white_cane:"	"ğŸ‘©â€ğŸ¦¯" 
":person_in_motorized_wheelchair:"	"ğŸ§‘â€ğŸ¦¼" 
":man_in_motorized_wheelchair:"	"ğŸ‘¨â€ğŸ¦¼" 
":woman_in_motorized_wheelchair:"	"ğŸ‘©â€ğŸ¦¼" 
":person_in_manual_wheelchair:"	"ğŸ§‘â€ğŸ¦½" 
":man_in_manual_wheelchair:"	"ğŸ‘¨â€ğŸ¦½" 
":woman_in_manual_wheelchair:"	"ğŸ‘©â€ğŸ¦½" 
":person_running:"	"ğŸƒ" 
":man_running:"	"ğŸƒâ€â™‚" 
":woman_running:"	"ğŸƒâ€â™€" 
":woman_dancing:"	"ğŸ’ƒ" 
":man_dancing:"	"ğŸ•º" 
":person_in_suit_levitating:"	"ğŸ•´" 
":people_with_bunny_ears:"	"ğŸ‘¯" 
":men_with_bunny_ears:"	"ğŸ‘¯â€â™‚" 
":women_with_bunny_ears:"	"ğŸ‘¯â€â™€" 
":person_in_steamy_room:"	"ğŸ§–" 
":man_in_steamy_room:"	"ğŸ§–â€â™‚" 
":woman_in_steamy_room:"	"ğŸ§–â€â™€" 
":person_climbing:"	"ğŸ§—" 
":man_climbing:"	"ğŸ§—â€â™‚" 
":woman_climbing:"	"ğŸ§—â€â™€" 
":person_fencing:"	"ğŸ¤º" 
":horse_racing:"	"ğŸ‡" 
":skier:"	"â›·" 
":snowboarder:"	"ğŸ‚" 
":person_golfing:"	"ğŸŒ" 
":man_golfing:"	"ğŸŒâ€â™‚" 
":woman_golfing:"	"ğŸŒâ€â™€" 
":person_surfing:"	"ğŸ„" 
":man_surfing:"	"ğŸ„â€â™‚" 
":woman_surfing:"	"ğŸ„â€â™€" 
":person_rowing_boat:"	"ğŸš£" 
":man_rowing_boat:"	"ğŸš£â€â™‚" 
":woman_rowing_boat:"	"ğŸš£â€â™€" 
":person_swimming:"	"ğŸŠ" 
":man_swimming:"	"ğŸŠâ€â™‚" 
":woman_swimming:"	"ğŸŠâ€â™€" 
":person_bouncing_ball:"	"â›¹" 
":man_bouncing_ball:"	"â›¹â€â™‚" 
":woman_bouncing_ball:"	"â›¹â€â™€" 
":person_lifting_weights:"	"ğŸ‹" 
":man_lifting_weights:"	"ğŸ‹â€â™‚" 
":woman_lifting_weights:"	"ğŸ‹â€â™€" 
":person_biking:"	"ğŸš´" 
":man_biking:"	"ğŸš´â€â™‚" 
":woman_biking:"	"ğŸš´â€â™€" 
":person_mountain_biking:"	"ğŸšµ" 
":man_mountain_biking:"	"ğŸšµâ€â™‚" 
":woman_mountain_biking:"	"ğŸšµâ€â™€" 
":person_cartwheeling:"	"ğŸ¤¸" 
":man_cartwheeling:"	"ğŸ¤¸â€â™‚" 
":woman_cartwheeling:"	"ğŸ¤¸â€â™€" 
":people_wrestling:"	"ğŸ¤¼" 
":men_wrestling:"	"ğŸ¤¼â€â™‚" 
":women_wrestling:"	"ğŸ¤¼â€â™€" 
":person_playing_water_polo:"	"ğŸ¤½" 
":man_playing_water_polo:"	"ğŸ¤½â€â™‚" 
":woman_playing_water_polo:"	"ğŸ¤½â€â™€" 
":person_playing_handball:"	"ğŸ¤¾" 
":man_playing_handball:"	"ğŸ¤¾â€â™‚" 
":woman_playing_handball:"	"ğŸ¤¾â€â™€" 
":person_juggling:"	"ğŸ¤¹" 
":man_juggling:"	"ğŸ¤¹â€â™‚" 
":woman_juggling:"	"ğŸ¤¹â€â™€" 
":person_in_lotus_position:"	"ğŸ§˜" 
":man_in_lotus_position:"	"ğŸ§˜â€â™‚" 
":woman_in_lotus_position:"	"ğŸ§˜â€â™€" 
":person_taking_bath:"	"ğŸ›€" 
":person_in_bed:"	"ğŸ›Œ" 
":people_holding_hands:"	"ğŸ§‘â€ğŸ¤â€ğŸ§‘" 
":women_holding_hands:"	"ğŸ‘­" 
":woman_and_man_holding_hands:"	"ğŸ‘«" 
":men_holding_hands:"	"ğŸ‘¬" 
":couplekiss:"	"ğŸ’" 
":kiss_woman_man:"	"ğŸ‘©â€â¤â€ğŸ’‹â€ğŸ‘¨" 
":kiss_man_man:"	"ğŸ‘¨â€â¤â€ğŸ’‹â€ğŸ‘¨" 
":kiss_woman_woman:"	"ğŸ‘©â€â¤â€ğŸ’‹â€ğŸ‘©" 
":couple_with_heart:"	"ğŸ’‘" 
":couple_with_heart_woman_man:"	"ğŸ‘©â€â¤â€ğŸ‘¨" 
":couple_with_heart_man_man:"	"ğŸ‘¨â€â¤â€ğŸ‘¨" 
":couple_with_heart_woman_woman:"	"ğŸ‘©â€â¤â€ğŸ‘©" 
":family:"	"ğŸ‘ª" 
":family_man_woman_boy:"	"ğŸ‘¨â€ğŸ‘©â€ğŸ‘¦" 
":family_man_woman_girl:"	"ğŸ‘¨â€ğŸ‘©â€ğŸ‘§" 
":family_man_woman_girl_boy:"	"ğŸ‘¨â€ğŸ‘©â€ğŸ‘§â€ğŸ‘¦" 
":family_man_woman_boy_boy:"	"ğŸ‘¨â€ğŸ‘©â€ğŸ‘¦â€ğŸ‘¦" 
":family_man_woman_girl_girl:"	"ğŸ‘¨â€ğŸ‘©â€ğŸ‘§â€ğŸ‘§" 
":family_man_man_boy:"	"ğŸ‘¨â€ğŸ‘¨â€ğŸ‘¦" 
":family_man_man_girl:"	"ğŸ‘¨â€ğŸ‘¨â€ğŸ‘§" 
":family_man_man_girl_boy:"	"ğŸ‘¨â€ğŸ‘¨â€ğŸ‘§â€ğŸ‘¦" 
":family_man_man_boy_boy:"	"ğŸ‘¨â€ğŸ‘¨â€ğŸ‘¦â€ğŸ‘¦" 
":family_man_man_girl_girl:"	"ğŸ‘¨â€ğŸ‘¨â€ğŸ‘§â€ğŸ‘§" 
":family_woman_woman_boy:"	"ğŸ‘©â€ğŸ‘©â€ğŸ‘¦" 
":family_woman_woman_girl:"	"ğŸ‘©â€ğŸ‘©â€ğŸ‘§" 
":family_woman_woman_girl_boy:"	"ğŸ‘©â€ğŸ‘©â€ğŸ‘§â€ğŸ‘¦" 
":family_woman_woman_boy_boy:"	"ğŸ‘©â€ğŸ‘©â€ğŸ‘¦â€ğŸ‘¦" 
":family_woman_woman_girl_girl:"	"ğŸ‘©â€ğŸ‘©â€ğŸ‘§â€ğŸ‘§" 
":family_man_boy:"	"ğŸ‘¨â€ğŸ‘¦" 
":family_man_boy_boy:"	"ğŸ‘¨â€ğŸ‘¦â€ğŸ‘¦" 
":family_man_girl:"	"ğŸ‘¨â€ğŸ‘§" 
":family_man_girl_boy:"	"ğŸ‘¨â€ğŸ‘§â€ğŸ‘¦" 
":family_man_girl_girl:"	"ğŸ‘¨â€ğŸ‘§â€ğŸ‘§" 
":family_woman_boy:"	"ğŸ‘©â€ğŸ‘¦" 
":family_woman_boy_boy:"	"ğŸ‘©â€ğŸ‘¦â€ğŸ‘¦" 
":family_woman_girl:"	"ğŸ‘©â€ğŸ‘§" 
":family_woman_girl_boy:"	"ğŸ‘©â€ğŸ‘§â€ğŸ‘¦" 
":family_woman_girl_girl:"	"ğŸ‘©â€ğŸ‘§â€ğŸ‘§" 
":speaking_head:"	"ğŸ—£" 
":bust_in_silhouette:"	"ğŸ‘¤" 
":busts_in_silhouette:"	"ğŸ‘¥" 
":people_hugging:"	"ğŸ«‚" 
":footprints:"	"ğŸ‘£" 

Category:	Nature
":monkey_face:"	"ğŸµ" 
":monkey:"	"ğŸ’" 
":gorilla:"	"ğŸ¦" 
":orangutan:"	"ğŸ¦§" 
":dog:"	"ğŸ¶" 
":dog2:"	"ğŸ•" 
":guide_dog:"	"ğŸ¦®" 
":service_dog:"	"ğŸ•â€ğŸ¦º" 
":poodle:"	"ğŸ©" 
":wolf:"	"ğŸº" 
":fox:"	"ğŸ¦Š" 
":raccoon:"	"ğŸ¦" 
":cat:"	"ğŸ±" 
":cat2:"	"ğŸˆ" 
":black_cat:"	"ğŸˆâ€â¬›" 
":lion:"	"ğŸ¦" 
":tiger:"	"ğŸ¯" 
":tiger2:"	"ğŸ…" 
":leopard:"	"ğŸ†" 
":horse:"	"ğŸ´" 
":racehorse:"	"ğŸ" 
":unicorn:"	"ğŸ¦„" 
":zebra:"	"ğŸ¦“" 
":deer:"	"ğŸ¦Œ" 
":bison:"	"ğŸ¦¬" 
":cow:"	"ğŸ®" 
":ox:"	"ğŸ‚" 
":water_buffalo:"	"ğŸƒ" 
":cow2:"	"ğŸ„" 
":pig:"	"ğŸ·" 
":pig2:"	"ğŸ–" 
":boar:"	"ğŸ—" 
":pig_nose:"	"ğŸ½" 
":ram:"	"ğŸ" 
":ewe:"	"ğŸ‘" 
":goat:"	"ğŸ" 
":dromedary_camel:"	"ğŸª" 
":camel:"	"ğŸ«" 
":llama:"	"ğŸ¦™" 
":giraffe:"	"ğŸ¦’" 
":elephant:"	"ğŸ˜" 
":mammoth:"	"ğŸ¦£" 
":rhinoceros:"	"ğŸ¦" 
":hippopotamus:"	"ğŸ¦›" 
":mouse:"	"ğŸ­" 
":mouse2:"	"ğŸ" 
":rat:"	"ğŸ€" 
":hamster:"	"ğŸ¹" 
":rabbit:"	"ğŸ°" 
":rabbit2:"	"ğŸ‡" 
":chipmunk:"	"ğŸ¿" 
":beaver:"	"ğŸ¦«" 
":hedgehog:"	"ğŸ¦”" 
":bat:"	"ğŸ¦‡" 
":bear:"	"ğŸ»" 
":polar_bear:"	"ğŸ»â€â„" 
":koala:"	"ğŸ¨" 
":panda:"	"ğŸ¼" 
":sloth:"	"ğŸ¦¥" 
":otter:"	"ğŸ¦¦" 
":skunk:"	"ğŸ¦¨" 
":kangaroo:"	"ğŸ¦˜" 
":badger:"	"ğŸ¦¡" 
":paw_prints:"	"ğŸ¾" 
":turkey:"	"ğŸ¦ƒ" 
":chicken:"	"ğŸ”" 
":rooster:"	"ğŸ“" 
":hatching_chick:"	"ğŸ£" 
":baby_chick:"	"ğŸ¤" 
":front_facing_baby_chick:"	"ğŸ¥" 
":bird:"	"ğŸ¦" 
":penguin:"	"ğŸ§" 
":dove:"	"ğŸ•Š" 
":eagle:"	"ğŸ¦…" 
":duck:"	"ğŸ¦†" 
":swan:"	"ğŸ¦¢" 
":owl:"	"ğŸ¦‰" 
":dodo:"	"ğŸ¦¤" 
":feather:"	"ğŸª¶" 
":flamingo:"	"ğŸ¦©" 
":peacock:"	"ğŸ¦š" 
":parrot:"	"ğŸ¦œ" 
":frog:"	"ğŸ¸" 
":crocodile:"	"ğŸŠ" 
":turtle:"	"ğŸ¢" 
":lizard:"	"ğŸ¦" 
":snake:"	"ğŸ" 
":dragon_face:"	"ğŸ²" 
":dragon:"	"ğŸ‰" 
":sauropod:"	"ğŸ¦•" 
":t_rex:"	"ğŸ¦–" 
":spouting_whale:"	"ğŸ³" 
":whale2:"	"ğŸ‹" 
":dolphin:"	"ğŸ¬" 
":seal:"	"ğŸ¦­" 
":fish:"	"ğŸŸ" 
":tropical_fish:"	"ğŸ " 
":blowfish:"	"ğŸ¡" 
":shark:"	"ğŸ¦ˆ" 
":octopus:"	"ğŸ™" 
":spiral_shell:"	"ğŸš" 
":snail:"	"ğŸŒ" 
":butterfly:"	"ğŸ¦‹" 
":bug:"	"ğŸ›" 
":ant:"	"ğŸœ" 
":honeybee:"	"ğŸ" 
":beetle:"	"ğŸª²" 
":lady_beetle:"	"ğŸ" 
":cricket:"	"ğŸ¦—" 
":cockroach:"	"ğŸª³" 
":spider:"	"ğŸ•·" 
":spider_web:"	"ğŸ•¸" 
":scorpion:"	"ğŸ¦‚" 
":mosquito:"	"ğŸ¦Ÿ" 
":fly:"	"ğŸª°" 
":worm:"	"ğŸª±" 
":microbe:"	"ğŸ¦ " 
":bouquet:"	"ğŸ’" 
":cherry_blossom:"	"ğŸŒ¸" 
":white_flower:"	"ğŸ’®" 
":rosette:"	"ğŸµ" 
":rose:"	"ğŸŒ¹" 
":wilted_flower:"	"ğŸ¥€" 
":hibiscus:"	"ğŸŒº" 
":sunflower:"	"ğŸŒ»" 
":blossom:"	"ğŸŒ¼" 
":tulip:"	"ğŸŒ·" 
":seedling:"	"ğŸŒ±" 
":potted_plant:"	"ğŸª´" 
":evergreen_tree:"	"ğŸŒ²" 
":deciduous_tree:"	"ğŸŒ³" 
":palm_tree:"	"ğŸŒ´" 
":cactus:"	"ğŸŒµ" 
":sheaf_of_rice:"	"ğŸŒ¾" 
":herb:"	"ğŸŒ¿" 
":shamrock:"	"â˜˜" 
":four_leaf_clover:"	"ğŸ€" 
":maple_leaf:"	"ğŸ" 
":fallen_leaf:"	"ğŸ‚" 
":leaf_fluttering_in_wind:"	"ğŸƒ" 

Category:	Food
":grapes:"	"ğŸ‡" 
":melon:"	"ğŸˆ" 
":watermelon:"	"ğŸ‰" 
":tangerine:"	"ğŸŠ" 
":lemon:"	"ğŸ‹" 
":banana:"	"ğŸŒ" 
":pineapple:"	"ğŸ" 
":mango:"	"ğŸ¥­" 
":red_apple:"	"ğŸ" 
":green_apple:"	"ğŸ" 
":pear:"	"ğŸ" 
":peach:"	"ğŸ‘" 
":cherries:"	"ğŸ’" 
":strawberry:"	"ğŸ“" 
":blueberries:"	"ğŸ«" 
":kiwi_fruit:"	"ğŸ¥" 
":tomato:"	"ğŸ…" 
":olive:"	"ğŸ«’" 
":coconut:"	"ğŸ¥¥" 
":avocado:"	"ğŸ¥‘" 
":eggplant:"	"ğŸ†" 
":potato:"	"ğŸ¥”" 
":carrot:"	"ğŸ¥•" 
":ear_of_corn:"	"ğŸŒ½" 
":hot_pepper:"	"ğŸŒ¶" 
":bell_pepper:"	"ğŸ«‘" 
":cucumber:"	"ğŸ¥’" 
":leafy_green:"	"ğŸ¥¬" 
":broccoli:"	"ğŸ¥¦" 
":garlic:"	"ğŸ§„" 
":onion:"	"ğŸ§…" 
":mushroom:"	"ğŸ„" 
":peanuts:"	"ğŸ¥œ" 
":chestnut:"	"ğŸŒ°" 
":bread:"	"ğŸ" 
":croissant:"	"ğŸ¥" 
":baguette_bread:"	"ğŸ¥–" 
":flatbread:"	"ğŸ«“" 
":pretzel:"	"ğŸ¥¨" 
":bagel:"	"ğŸ¥¯" 
":pancakes:"	"ğŸ¥" 
":waffle:"	"ğŸ§‡" 
":cheese_wedge:"	"ğŸ§€" 
":meat_on_bone:"	"ğŸ–" 
":poultry_leg:"	"ğŸ—" 
":cut_of_meat:"	"ğŸ¥©" 
":bacon:"	"ğŸ¥“" 
":hamburger:"	"ğŸ”" 
":french_fries:"	"ğŸŸ" 
":pizza:"	"ğŸ•" 
":hot_dog:"	"ğŸŒ­" 
":sandwich:"	"ğŸ¥ª" 
":taco:"	"ğŸŒ®" 
":burrito:"	"ğŸŒ¯" 
":tamale:"	"ğŸ«”" 
":stuffed_flatbread:"	"ğŸ¥™" 
":falafel:"	"ğŸ§†" 
":egg2:"	"ğŸ¥š" 
":cooking:"	"ğŸ³" 
":shallow_pan_of_food:"	"ğŸ¥˜" 
":pot_of_food:"	"ğŸ²" 
":fondue:"	"ğŸ«•" 
":bowl_with_spoon:"	"ğŸ¥£" 
":green_salad:"	"ğŸ¥—" 
":popcorn:"	"ğŸ¿" 
":butter:"	"ğŸ§ˆ" 
":salt:"	"ğŸ§‚" 
":canned_food:"	"ğŸ¥«" 
":bento_box:"	"ğŸ±" 
":rice_cracker:"	"ğŸ˜" 
":rice_ball:"	"ğŸ™" 
":cooked_rice:"	"ğŸš" 
":curry_rice:"	"ğŸ›" 
":steaming_bowl:"	"ğŸœ" 
":spaghetti:"	"ğŸ" 
":roasted_sweet_potato:"	"ğŸ " 
":oden:"	"ğŸ¢" 
":sushi:"	"ğŸ£" 
":fried_shrimp:"	"ğŸ¤" 
":fish_cake_with_swirl:"	"ğŸ¥" 
":moon_cake:"	"ğŸ¥®" 
":dango:"	"ğŸ¡" 
":dumpling:"	"ğŸ¥Ÿ" 
":fortune_cookie:"	"ğŸ¥ " 
":takeout_box:"	"ğŸ¥¡" 
":crab:"	"ğŸ¦€" 
":lobster:"	"ğŸ¦" 
":shrimp:"	"ğŸ¦" 
":squid:"	"ğŸ¦‘" 
":oyster:"	"ğŸ¦ª" 
":soft_ice_cream:"	"ğŸ¦" 
":shaved_ice:"	"ğŸ§" 
":ice_cream:"	"ğŸ¨" 
":doughnut:"	"ğŸ©" 
":cookie:"	"ğŸª" 
":birthday_cake:"	"ğŸ‚" 
":shortcake:"	"ğŸ°" 
":cupcake:"	"ğŸ§" 
":pie:"	"ğŸ¥§" 
":chocolate_bar:"	"ğŸ«" 
":candy:"	"ğŸ¬" 
":lollipop:"	"ğŸ­" 
":custard:"	"ğŸ®" 
":honey_pot:"	"ğŸ¯" 
":baby_bottle:"	"ğŸ¼" 
":glass_of_milk:"	"ğŸ¥›" 
":hot_beverage:"	"â˜•" 
":teapot:"	"ğŸ«–" 
":teacup_without_handle:"	"ğŸµ" 
":sake:"	"ğŸ¶" 
":bottle_with_popping_cork:"	"ğŸ¾" 
":wine_glass:"	"ğŸ·" 
":cocktail_glass:"	"ğŸ¸" 
":tropical_drink:"	"ğŸ¹" 
":beer_mug:"	"ğŸº" 
":clinking_beer_mugs:"	"ğŸ»" 
":clinking_glasses:"	"ğŸ¥‚" 
":tumbler_glass:"	"ğŸ¥ƒ" 
":cup_with_straw:"	"ğŸ¥¤" 
":bubble_tea:"	"ğŸ§‹" 
":beverage_box:"	"ğŸ§ƒ" 
":mate:"	"ğŸ§‰" 
":ice:"	"ğŸ§Š" 
":chopsticks:"	"ğŸ¥¢" 
":fork_and_knife_with_plate:"	"ğŸ½" 
":fork_and_knife:"	"ğŸ´" 
":spoon:"	"ğŸ¥„" 
":kitchen_knife:"	"ğŸ”ª" 
":amphora:"	"ğŸº" 

Category:	Travel
":globe_showing_europe_africa:"	"ğŸŒ" 
":globe_showing_americas:"	"ğŸŒ" 
":globe_showing_asia_australia:"	"ğŸŒ" 
":globe_with_meridians:"	"ğŸŒ" 
":world_map:"	"ğŸ—º" 
":map_of_japan:"	"ğŸ—¾" 
":compass:"	"ğŸ§­" 
":snow_capped_mountain:"	"ğŸ”" 
":mountain:"	"â›°" 
":volcano:"	"ğŸŒ‹" 
":mount_fuji:"	"ğŸ—»" 
":camping:"	"ğŸ•" 
":beach_with_umbrella:"	"ğŸ–" 
":desert:"	"ğŸœ" 
":desert_island:"	"ğŸ" 
":national_park:"	"ğŸ" 
":stadium:"	"ğŸŸ" 
":classical_building:"	"ğŸ›" 
":building_construction:"	"ğŸ—" 
":brick:"	"ğŸ§±" 
":rock:"	"ğŸª¨" 
":wood:"	"ğŸªµ" 
":hut:"	"ğŸ›–" 
":houses:"	"ğŸ˜" 
":derelict_house:"	"ğŸš" 
":house:"	"ğŸ " 
":house_with_garden:"	"ğŸ¡" 
":office_building:"	"ğŸ¢" 
":japanese_post_office:"	"ğŸ£" 
":european_post_office:"	"ğŸ¤" 
":hospital:"	"ğŸ¥" 
":bank:"	"ğŸ¦" 
":hotel:"	"ğŸ¨" 
":love_hotel:"	"ğŸ©" 
":convenience_store:"	"ğŸª" 
":school:"	"ğŸ«" 
":department_store:"	"ğŸ¬" 
":factory:"	"ğŸ­" 
":japanese_castle:"	"ğŸ¯" 
":castle:"	"ğŸ°" 
":wedding:"	"ğŸ’’" 
":tokyo_tower:"	"ğŸ—¼" 
":statue_of_liberty:"	"ğŸ—½" 
":church:"	"â›ª" 
":mosque:"	"ğŸ•Œ" 
":hindu_temple:"	"ğŸ›•" 
":synagogue:"	"ğŸ•" 
":shinto_shrine:"	"â›©" 
":kaaba:"	"ğŸ•‹" 
":fountain:"	"â›²" 
":tent:"	"â›º" 
":foggy:"	"ğŸŒ" 
":night_with_stars:"	"ğŸŒƒ" 
":cityscape:"	"ğŸ™" 
":sunrise_over_mountains:"	"ğŸŒ„" 
":sunrise:"	"ğŸŒ…" 
":cityscape_at_dusk:"	"ğŸŒ†" 
":sunset:"	"ğŸŒ‡" 
":bridge_at_night:"	"ğŸŒ‰" 
":hot_springs:"	"â™¨" 
":carousel_horse:"	"ğŸ " 
":ferris_wheel:"	"ğŸ¡" 
":roller_coaster:"	"ğŸ¢" 
":barber_pole:"	"ğŸ’ˆ" 
":circus_tent:"	"ğŸª" 
":locomotive:"	"ğŸš‚" 
":railway_car:"	"ğŸšƒ" 
":high_speed_train:"	"ğŸš„" 
":bullet_train:"	"ğŸš…" 
":train2:"	"ğŸš†" 
":metro:"	"ğŸš‡" 
":light_rail:"	"ğŸšˆ" 
":station:"	"ğŸš‰" 
":tram:"	"ğŸšŠ" 
":monorail:"	"ğŸš" 
":mountain_railway:"	"ğŸš" 
":train:"	"ğŸš‹" 
":bus:"	"ğŸšŒ" 
":oncoming_bus:"	"ğŸš" 
":trolleybus:"	"ğŸš" 
":minibus:"	"ğŸš" 
":ambulance:"	"ğŸš‘" 
":fire_engine:"	"ğŸš’" 
":police_car:"	"ğŸš“" 
":oncoming_police_car:"	"ğŸš”" 
":taxi:"	"ğŸš•" 
":oncoming_taxi:"	"ğŸš–" 
":automobile:"	"ğŸš—" 
":oncoming_automobile:"	"ğŸš˜" 
":sport_utility_vehicle:"	"ğŸš™" 
":pickup_truck:"	"ğŸ›»" 
":delivery_truck:"	"ğŸšš" 
":articulated_lorry:"	"ğŸš›" 
":tractor:"	"ğŸšœ" 
":racing_car:"	"ğŸ" 
":motorcycle:"	"ğŸ" 
":motor_scooter:"	"ğŸ›µ" 
":manual_wheelchair:"	"ğŸ¦½" 
":motorized_wheelchair:"	"ğŸ¦¼" 
":auto_rickshaw:"	"ğŸ›º" 
":bicycle:"	"ğŸš²" 
":kick_scooter:"	"ğŸ›´" 
":skateboard:"	"ğŸ›¹" 
":roller_skate:"	"ğŸ›¼" 
":bus_stop:"	"ğŸš" 
":motorway:"	"ğŸ›£" 
":railway_track:"	"ğŸ›¤" 
":oil_drum:"	"ğŸ›¢" 
":fuel_pump:"	"â›½" 
":police_car_light:"	"ğŸš¨" 
":horizontal_traffic_light:"	"ğŸš¥" 
":vertical_traffic_light:"	"ğŸš¦" 
":stop_sign:"	"ğŸ›‘" 
":construction:"	"ğŸš§" 
":anchor:"	"âš“" 
":sailboat:"	"â›µ" 
":canoe:"	"ğŸ›¶" 
":speedboat:"	"ğŸš¤" 
":passenger_ship:"	"ğŸ›³" 
":ferry:"	"â›´" 
":motor_boat:"	"ğŸ›¥" 
":ship:"	"ğŸš¢" 
":airplane:"	"âœˆ" 
":small_airplane:"	"ğŸ›©" 
":airplane_departure:"	"ğŸ›«" 
":airplane_arrival:"	"ğŸ›¬" 
":parachute:"	"ğŸª‚" 
":seat:"	"ğŸ’º" 
":helicopter:"	"ğŸš" 
":suspension_railway:"	"ğŸšŸ" 
":mountain_cableway:"	"ğŸš " 
":aerial_tramway:"	"ğŸš¡" 
":satellite:"	"ğŸ›°" 
":rocket:"	"ğŸš€" 
":flying_saucer:"	"ğŸ›¸" 
":bellhop_bell:"	"ğŸ›" 
":luggage:"	"ğŸ§³" 
":hourglass_done:"	"âŒ›" 
":hourglass_not_done:"	"â³" 
":watch:"	"âŒš" 
":alarm_clock:"	"â°" 
":stopwatch:"	"â±" 
":timer_clock:"	"â²" 
":mantelpiece_clock:"	"ğŸ•°" 
":twelve_oâ€™clock:"	"ğŸ•›" 
":twelve_thirty:"	"ğŸ•§" 
":one_oâ€™clock:"	"ğŸ•" 
":one_thirty:"	"ğŸ•œ" 
":two_oâ€™clock:"	"ğŸ•‘" 
":two_thirty:"	"ğŸ•" 
":three_oâ€™clock:"	"ğŸ•’" 
":three_thirty:"	"ğŸ•" 
":four_oâ€™clock:"	"ğŸ•“" 
":four_thirty:"	"ğŸ•Ÿ" 
":five_oâ€™clock:"	"ğŸ•”" 
":five_thirty:"	"ğŸ• " 
":six_oâ€™clock:"	"ğŸ••" 
":six_thirty:"	"ğŸ•¡" 
":seven_oâ€™clock:"	"ğŸ•–" 
":seven_thirty:"	"ğŸ•¢" 
":eight_oâ€™clock:"	"ğŸ•—" 
":eight_thirty:"	"ğŸ•£" 
":nine_oâ€™clock:"	"ğŸ•˜" 
":nine_thirty:"	"ğŸ•¤" 
":ten_oâ€™clock:"	"ğŸ•™" 
":ten_thirty:"	"ğŸ•¥" 
":eleven_oâ€™clock:"	"ğŸ•š" 
":eleven_thirty:"	"ğŸ•¦" 
":new_moon:"	"ğŸŒ‘" 
":waxing_crescent_moon:"	"ğŸŒ’" 
":first_quarter_moon:"	"ğŸŒ“" 
":waxing_gibbous_moon:"	"ğŸŒ”" 
":full_moon:"	"ğŸŒ•" 
":waning_gibbous_moon:"	"ğŸŒ–" 
":last_quarter_moon:"	"ğŸŒ—" 
":waning_crescent_moon:"	"ğŸŒ˜" 
":crescent_moon:"	"ğŸŒ™" 
":new_moon_face:"	"ğŸŒš" 
":first_quarter_moon_face:"	"ğŸŒ›" 
":last_quarter_moon_face:"	"ğŸŒœ" 
":thermometer:"	"ğŸŒ¡" 
":sun:"	"â˜€" 
":full_moon_face:"	"ğŸŒ" 
":sun_with_face:"	"ğŸŒ" 
":ringed_planet:"	"ğŸª" 
":star:"	"â­" 
":glowing_star:"	"ğŸŒŸ" 
":shooting_star:"	"ğŸŒ " 
":milky_way:"	"ğŸŒŒ" 
":cloud:"	"â˜" 
":sun_behind_cloud:"	"â›…" 
":cloud_with_lightning_and_rain:"	"â›ˆ" 
":sun_behind_small_cloud:"	"ğŸŒ¤" 
":sun_behind_large_cloud:"	"ğŸŒ¥" 
":sun_behind_rain_cloud:"	"ğŸŒ¦" 
":cloud_with_rain:"	"ğŸŒ§" 
":cloud_with_snow:"	"ğŸŒ¨" 
":cloud_with_lightning:"	"ğŸŒ©" 
":tornado:"	"ğŸŒª" 
":fog:"	"ğŸŒ«" 
":wind_face:"	"ğŸŒ¬" 
":cyclone:"	"ğŸŒ€" 
":rainbow:"	"ğŸŒˆ" 
":closed_umbrella:"	"ğŸŒ‚" 
":umbrella:"	"â˜‚" 
":umbrella_with_rain_drops:"	"â˜”" 
":umbrella_on_ground:"	"â›±" 
":high_voltage:"	"âš¡" 
":snowflake:"	"â„" 
":snowman:"	"â˜ƒ" 
":snowman_without_snow:"	"â›„" 
":comet:"	"â˜„" 
":fire:"	"ğŸ”¥" 
":droplet:"	"ğŸ’§" 
":water_wave:"	"ğŸŒŠ" 

Category:	Activities
":jack_o_lantern:"	"ğŸƒ" 
":christmas_tree:"	"ğŸ„" 
":fireworks:"	"ğŸ†" 
":sparkler:"	"ğŸ‡" 
":firecracker:"	"ğŸ§¨" 
":sparkles:"	"âœ¨" 
":balloon:"	"ğŸˆ" 
":party_popper:"	"ğŸ‰" 
":confetti_ball:"	"ğŸŠ" 
":tanabata_tree:"	"ğŸ‹" 
":pine_decoration:"	"ğŸ" 
":japanese_dolls:"	"ğŸ" 
":carp_streamer:"	"ğŸ" 
":wind_chime:"	"ğŸ" 
":moon_viewing_ceremony:"	"ğŸ‘" 
":red_envelope:"	"ğŸ§§" 
":ribbon:"	"ğŸ€" 
":wrapped_gift:"	"ğŸ" 
":reminder_ribbon:"	"ğŸ—" 
":admission_tickets:"	"ğŸŸ" 
":ticket:"	"ğŸ«" 
":military_medal:"	"ğŸ–" 
":trophy:"	"ğŸ†" 
":sports_medal:"	"ğŸ…" 
":1st_place_medal:"	"ğŸ¥‡" 
":2nd_place_medal:"	"ğŸ¥ˆ" 
":3rd_place_medal:"	"ğŸ¥‰" 
":soccer_ball:"	"âš½" 
":baseball:"	"âš¾" 
":softball:"	"ğŸ¥" 
":basketball:"	"ğŸ€" 
":volleyball:"	"ğŸ" 
":american_football:"	"ğŸˆ" 
":rugby_football:"	"ğŸ‰" 
":tennis:"	"ğŸ¾" 
":flying_disc:"	"ğŸ¥" 
":bowling:"	"ğŸ³" 
":cricket_game:"	"ğŸ" 
":field_hockey:"	"ğŸ‘" 
":ice_hockey:"	"ğŸ’" 
":lacrosse:"	"ğŸ¥" 
":ping_pong:"	"ğŸ“" 
":badminton:"	"ğŸ¸" 
":boxing_glove:"	"ğŸ¥Š" 
":martial_arts_uniform:"	"ğŸ¥‹" 
":goal_net:"	"ğŸ¥…" 
":flag_in_hole:"	"â›³" 
":ice_skate:"	"â›¸" 
":fishing_pole:"	"ğŸ£" 
":diving_mask:"	"ğŸ¤¿" 
":running_shirt:"	"ğŸ½" 
":skis:"	"ğŸ¿" 
":sled:"	"ğŸ›·" 
":curling_stone:"	"ğŸ¥Œ" 
":bullseye:"	"ğŸ¯" 
":yo_yo:"	"ğŸª€" 
":kite:"	"ğŸª" 
":pool_8_ball:"	"ğŸ±" 
":crystal_ball:"	"ğŸ”®" 
":magic_wand:"	"ğŸª„" 
":nazar_amulet:"	"ğŸ§¿" 
":video_game:"	"ğŸ®" 
":joystick:"	"ğŸ•¹" 
":slot_machine:"	"ğŸ°" 
":game_die:"	"ğŸ²" 
":puzzle_piece:"	"ğŸ§©" 
":teddy_bear:"	"ğŸ§¸" 
":piÃ±ata:"	"ğŸª…" 
":nesting_dolls:"	"ğŸª†" 
":spade_suit:"	"â™ " 
":heart_suit:"	"â™¥" 
":diamond_suit:"	"â™¦" 
":club_suit:"	"â™£" 
":chess_pawn:"	"â™Ÿ" 
":joker:"	"ğŸƒ" 
":mahjong_red_dragon:"	"ğŸ€„" 
":flower_playing_cards:"	"ğŸ´" 
":performing_arts:"	"ğŸ­" 
":framed_picture:"	"ğŸ–¼" 
":artist_palette:"	"ğŸ¨" 
":thread:"	"ğŸ§µ" 
":sewing_needle:"	"ğŸª¡" 
":yarn:"	"ğŸ§¶" 
":knot:"	"ğŸª¢" 

Category:	Objects
":glasses:"	"ğŸ‘“" 
":dark_sunglasses:"	"ğŸ•¶" 
":goggles:"	"ğŸ¥½" 
":lab_coat:"	"ğŸ¥¼" 
":safety_vest:"	"ğŸ¦º" 
":necktie:"	"ğŸ‘”" 
":t_shirt:"	"ğŸ‘•" 
":jeans:"	"ğŸ‘–" 
":scarf:"	"ğŸ§£" 
":gloves:"	"ğŸ§¤" 
":coat:"	"ğŸ§¥" 
":socks:"	"ğŸ§¦" 
":dress:"	"ğŸ‘—" 
":kimono:"	"ğŸ‘˜" 
":sari:"	"ğŸ¥»" 
":one_piece_swimsuit:"	"ğŸ©±" 
":briefs:"	"ğŸ©²" 
":shorts:"	"ğŸ©³" 
":bikini:"	"ğŸ‘™" 
":womanâ€™s_clothes:"	"ğŸ‘š" 
":purse:"	"ğŸ‘›" 
":handbag:"	"ğŸ‘œ" 
":clutch_bag:"	"ğŸ‘" 
":shopping_bags:"	"ğŸ›" 
":backpack:"	"ğŸ’" 
":thong_sandal:"	"ğŸ©´" 
":manâ€™s_shoe:"	"ğŸ‘" 
":running_shoe:"	"ğŸ‘Ÿ" 
":hiking_boot:"	"ğŸ¥¾" 
":flat_shoe:"	"ğŸ¥¿" 
":high_heeled_shoe:"	"ğŸ‘ " 
":womanâ€™s_sandal:"	"ğŸ‘¡" 
":ballet_shoes:"	"ğŸ©°" 
":womanâ€™s_boot:"	"ğŸ‘¢" 
":crown:"	"ğŸ‘‘" 
":womanâ€™s_hat:"	"ğŸ‘’" 
":top_hat:"	"ğŸ©" 
":graduation_cap:"	"ğŸ“" 
":billed_cap:"	"ğŸ§¢" 
":military_helmet:"	"ğŸª–" 
":rescue_workerâ€™s_helmet:"	"â›‘" 
":prayer_beads:"	"ğŸ“¿" 
":lipstick:"	"ğŸ’„" 
":ring:"	"ğŸ’" 
":gem_stone:"	"ğŸ’" 
":muted_speaker:"	"ğŸ”‡" 
":speaker_low_volume:"	"ğŸ”ˆ" 
":speaker_medium_volume:"	"ğŸ”‰" 
":speaker_high_volume:"	"ğŸ”Š" 
":loudspeaker:"	"ğŸ“¢" 
":megaphone:"	"ğŸ“£" 
":postal_horn:"	"ğŸ“¯" 
":bell:"	"ğŸ””" 
":bell_with_slash:"	"ğŸ”•" 
":musical_score:"	"ğŸ¼" 
":musical_note:"	"ğŸµ" 
":musical_notes:"	"ğŸ¶" 
":studio_microphone:"	"ğŸ™" 
":level_slider:"	"ğŸš" 
":control_knobs:"	"ğŸ›" 
":microphone:"	"ğŸ¤" 
":headphone:"	"ğŸ§" 
":radio:"	"ğŸ“»" 
":saxophone:"	"ğŸ·" 
":accordion:"	"ğŸª—" 
":guitar:"	"ğŸ¸" 
":musical_keyboard:"	"ğŸ¹" 
":trumpet:"	"ğŸº" 
":violin:"	"ğŸ»" 
":banjo:"	"ğŸª•" 
":drum:"	"ğŸ¥" 
":long_drum:"	"ğŸª˜" 
":mobile_phone:"	"ğŸ“±" 
":mobile_phone_with_arrow:"	"ğŸ“²" 
":telephone:"	"â˜" 
":telephone_receiver:"	"ğŸ“" 
":pager:"	"ğŸ“Ÿ" 
":fax_machine:"	"ğŸ“ " 
":battery:"	"ğŸ”‹" 
":electric_plug:"	"ğŸ”Œ" 
":laptop:"	"ğŸ’»" 
":desktop_computer:"	"ğŸ–¥" 
":printer:"	"ğŸ–¨" 
":keyboard:"	"âŒ¨" 
":computer_mouse:"	"ğŸ–±" 
":trackball:"	"ğŸ–²" 
":computer_disk:"	"ğŸ’½" 
":floppy_disk:"	"ğŸ’¾" 
":optical_disk:"	"ğŸ’¿" 
":dvd:"	"ğŸ“€" 
":abacus:"	"ğŸ§®" 
":movie_camera:"	"ğŸ¥" 
":film_frames:"	"ğŸ" 
":film_projector:"	"ğŸ“½" 
":clapper_board:"	"ğŸ¬" 
":television:"	"ğŸ“º" 
":camera:"	"ğŸ“·" 
":camera_with_flash:"	"ğŸ“¸" 
":video_camera:"	"ğŸ“¹" 
":videocassette:"	"ğŸ“¼" 
":magnifying_glass_tilted_left:"	"ğŸ”" 
":magnifying_glass_tilted_right:"	"ğŸ”" 
":candle:"	"ğŸ•¯" 
":light_bulb:"	"ğŸ’¡" 
":flashlight:"	"ğŸ”¦" 
":red_paper_lantern:"	"ğŸ®" 
":diya_lamp:"	"ğŸª”" 
":notebook_with_decorative_cover:"	"ğŸ“”" 
":closed_book:"	"ğŸ“•" 
":open_book:"	"ğŸ“–" 
":green_book:"	"ğŸ“—" 
":blue_book:"	"ğŸ“˜" 
":orange_book:"	"ğŸ“™" 
":books:"	"ğŸ“š" 
":notebook:"	"ğŸ““" 
":ledger:"	"ğŸ“’" 
":page_with_curl:"	"ğŸ“ƒ" 
":scroll:"	"ğŸ“œ" 
":page_facing_up:"	"ğŸ“„" 
":newspaper:"	"ğŸ“°" 
":rolled_up_newspaper:"	"ğŸ—" 
":bookmark_tabs:"	"ğŸ“‘" 
":bookmark:"	"ğŸ”–" 
":label:"	"ğŸ·" 
":money_bag:"	"ğŸ’°" 
":coin:"	"ğŸª™" 
":yen_banknote:"	"ğŸ’´" 
":dollar_banknote:"	"ğŸ’µ" 
":euro_banknote:"	"ğŸ’¶" 
":pound_banknote:"	"ğŸ’·" 
":money_with_wings:"	"ğŸ’¸" 
":credit_card:"	"ğŸ’³" 
":receipt:"	"ğŸ§¾" 
":chart_increasing_with_yen:"	"ğŸ’¹" 
":envelope:"	"âœ‰" 
":e_mail:"	"ğŸ“§" 
":incoming_envelope:"	"ğŸ“¨" 
":envelope_with_arrow:"	"ğŸ“©" 
":outbox_tray:"	"ğŸ“¤" 
":inbox_tray:"	"ğŸ“¥" 
":package:"	"ğŸ“¦" 
":closed_mailbox_with_raised_flag:"	"ğŸ“«" 
":closed_mailbox_with_lowered_flag:"	"ğŸ“ª" 
":open_mailbox_with_raised_flag:"	"ğŸ“¬" 
":open_mailbox_with_lowered_flag:"	"ğŸ“­" 
":postbox:"	"ğŸ“®" 
":ballot_box_with_ballot:"	"ğŸ—³" 
":pencil2:"	"âœ" 
":black_nib:"	"âœ’" 
":fountain_pen:"	"ğŸ–‹" 
":pen:"	"ğŸ–Š" 
":paintbrush:"	"ğŸ–Œ" 
":crayon:"	"ğŸ–" 
":memo:"	"ğŸ“" 
":briefcase:"	"ğŸ’¼" 
":file_folder:"	"ğŸ“" 
":open_file_folder:"	"ğŸ“‚" 
":card_index_dividers:"	"ğŸ—‚" 
":date:"	"ğŸ“…" 
":calendar:"	"ğŸ“†" 
":spiral_notepad:"	"ğŸ—’" 
":spiral_calendar:"	"ğŸ—“" 
":card_index:"	"ğŸ“‡" 
":chart_increasing:"	"ğŸ“ˆ" 
":chart_decreasing:"	"ğŸ“‰" 
":bar_chart:"	"ğŸ“Š" 
":clipboard:"	"ğŸ“‹" 
":pushpin:"	"ğŸ“Œ" 
":round_pushpin:"	"ğŸ“" 
":paperclip:"	"ğŸ“" 
":linked_paperclips:"	"ğŸ–‡" 
":straight_ruler:"	"ğŸ“" 
":triangular_ruler:"	"ğŸ“" 
":scissors:"	"âœ‚" 
":card_file_box:"	"ğŸ—ƒ" 
":file_cabinet:"	"ğŸ—„" 
":wastebasket:"	"ğŸ—‘" 
":locked:"	"ğŸ”’" 
":unlocked:"	"ğŸ”“" 
":locked_with_pen:"	"ğŸ”" 
":locked_with_key:"	"ğŸ”" 
":key:"	"ğŸ”‘" 
":old_key:"	"ğŸ—" 
":hammer:"	"ğŸ”¨" 
":axe:"	"ğŸª“" 
":pick:"	"â›" 
":hammer_and_pick:"	"âš’" 
":hammer_and_wrench:"	"ğŸ› " 
":dagger:"	"ğŸ—¡" 
":crossed_swords:"	"âš”" 
":water_pistol:"	"ğŸ”«" 
":boomerang:"	"ğŸªƒ" 
":bow_and_arrow:"	"ğŸ¹" 
":shield:"	"ğŸ›¡" 
":carpentry_saw:"	"ğŸªš" 
":wrench:"	"ğŸ”§" 
":screwdriver:"	"ğŸª›" 
":nut_and_bolt:"	"ğŸ”©" 
":gear:"	"âš™" 
":clamp:"	"ğŸ—œ" 
":balance_scale:"	"âš–" 
":white_cane:"	"ğŸ¦¯" 
":link:"	"ğŸ”—" 
":chains:"	"â›“" 
":hook:"	"ğŸª" 
":toolbox:"	"ğŸ§°" 
":magnet:"	"ğŸ§²" 
":ladder:"	"ğŸªœ" 
":alembic:"	"âš—" 
":test_tube:"	"ğŸ§ª" 
":petri_dish:"	"ğŸ§«" 
":dna:"	"ğŸ§¬" 
":microscope:"	"ğŸ”¬" 
":telescope:"	"ğŸ”­" 
":satellite_antenna:"	"ğŸ“¡" 
":syringe:"	"ğŸ’‰" 
":drop_of_blood:"	"ğŸ©¸" 
":pill:"	"ğŸ’Š" 
":adhesive_bandage:"	"ğŸ©¹" 
":stethoscope:"	"ğŸ©º" 
":door:"	"ğŸšª" 
":elevator:"	"ğŸ›—" 
":mirror:"	"ğŸª" 
":window:"	"ğŸªŸ" 
":bed:"	"ğŸ›" 
":couch_and_lamp:"	"ğŸ›‹" 
":chair:"	"ğŸª‘" 
":toilet:"	"ğŸš½" 
":plunger:"	"ğŸª " 
":shower:"	"ğŸš¿" 
":bathtub:"	"ğŸ›" 
":mouse_trap:"	"ğŸª¤" 
":razor:"	"ğŸª’" 
":lotion_bottle:"	"ğŸ§´" 
":safety_pin:"	"ğŸ§·" 
":broom:"	"ğŸ§¹" 
":basket:"	"ğŸ§º" 
":roll_of_paper:"	"ğŸ§»" 
":bucket:"	"ğŸª£" 
":soap:"	"ğŸ§¼" 
":toothbrush:"	"ğŸª¥" 
":sponge:"	"ğŸ§½" 
":fire_extinguisher:"	"ğŸ§¯" 
":shopping_cart:"	"ğŸ›’" 
":cigarette:"	"ğŸš¬" 
":coffin:"	"âš°" 
":headstone:"	"ğŸª¦" 
":funeral_urn:"	"âš±" 
":moai:"	"ğŸ—¿" 
":placard:"	"ğŸª§" 

Category:	Symbols
":atm_sign:"	"ğŸ§" 
":litter_in_bin_sign:"	"ğŸš®" 
":potable_water:"	"ğŸš°" 
":wheelchair_symbol:"	"â™¿" 
":menâ€™s_room:"	"ğŸš¹" 
":womenâ€™s_room:"	"ğŸšº" 
":restroom:"	"ğŸš»" 
":baby_symbol:"	"ğŸš¼" 
":water_closet:"	"ğŸš¾" 
":passport_control:"	"ğŸ›‚" 
":customs:"	"ğŸ›ƒ" 
":baggage_claim:"	"ğŸ›„" 
":left_luggage:"	"ğŸ›…" 
":warning:"	"âš " 
":children_crossing:"	"ğŸš¸" 
":no_entry:"	"â›”" 
":prohibited:"	"ğŸš«" 
":no_bicycles:"	"ğŸš³" 
":no_smoking:"	"ğŸš­" 
":no_littering:"	"ğŸš¯" 
":non_potable_water:"	"ğŸš±" 
":no_pedestrians:"	"ğŸš·" 
":no_mobile_phones:"	"ğŸ“µ" 
":no_one_under_eighteen:"	"ğŸ”" 
":radioactive:"	"â˜¢" 
":biohazard:"	"â˜£" 
":up_arrow:"	"â¬†" 
":up_right_arrow:"	"â†—" 
":right_arrow:"	"â¡" 
":down_right_arrow:"	"â†˜" 
":down_arrow:"	"â¬‡" 
":down_left_arrow:"	"â†™" 
":left_arrow:"	"â¬…" 
":up_left_arrow:"	"â†–" 
":up_down_arrow:"	"â†•" 
":left_right_arrow:"	"â†”" 
":right_arrow_curving_left:"	"â†©" 
":left_arrow_curving_right:"	"â†ª" 
":right_arrow_curving_up:"	"â¤´" 
":right_arrow_curving_down:"	"â¤µ" 
":clockwise_vertical_arrows:"	"ğŸ”ƒ" 
":counterclockwise_arrows_button:"	"ğŸ”„" 
":back_arrow:"	"ğŸ”™" 
":end_arrow:"	"ğŸ”š" 
":on!_arrow:"	"ğŸ”›" 
":soon_arrow:"	"ğŸ”œ" 
":top_arrow:"	"ğŸ”" 
":place_of_worship:"	"ğŸ›" 
":atom_symbol:"	"âš›" 
":om:"	"ğŸ•‰" 
":star_of_david:"	"âœ¡" 
":wheel_of_dharma:"	"â˜¸" 
":yin_yang:"	"â˜¯" 
":latin_cross:"	"âœ" 
":orthodox_cross:"	"â˜¦" 
":star_and_crescent:"	"â˜ª" 
":peace_symbol:"	"â˜®" 
":menorah:"	"ğŸ•" 
":dotted_six_pointed_star:"	"ğŸ”¯" 
":aries:"	"â™ˆ" 
":taurus:"	"â™‰" 
":gemini:"	"â™Š" 
":cancer:"	"â™‹" 
":leo:"	"â™Œ" 
":virgo:"	"â™" 
":libra:"	"â™" 
":scorpio:"	"â™" 
":sagittarius:"	"â™" 
":capricorn:"	"â™‘" 
":aquarius:"	"â™’" 
":pisces:"	"â™“" 
":ophiuchus:"	"â›" 
":shuffle_tracks_button:"	"ğŸ”€" 
":repeat_button:"	"ğŸ”" 
":repeat_single_button:"	"ğŸ”‚" 
":play_button:"	"â–¶" 
":fast_forward_button:"	"â©" 
":next_track_button:"	"â­" 
":play_or_pause_button:"	"â¯" 
":reverse_button:"	"â—€" 
":fast_reverse_button:"	"âª" 
":last_track_button:"	"â®" 
":upwards_button:"	"ğŸ”¼" 
":fast_up_button:"	"â«" 
":downwards_button:"	"ğŸ”½" 
":fast_down_button:"	"â¬" 
":pause_button:"	"â¸" 
":stop_button:"	"â¹" 
":record_button:"	"âº" 
":eject_button:"	"â" 
":cinema:"	"ğŸ¦" 
":dim_button:"	"ğŸ”…" 
":bright_button:"	"ğŸ”†" 
":antenna_bars:"	"ğŸ“¶" 
":vibration_mode:"	"ğŸ“³" 
":mobile_phone_off:"	"ğŸ“´" 
":female_sign:"	"â™€" 
":male_sign:"	"â™‚" 
":transgender_symbol:"	"âš§" 
":multiply:"	"âœ–" 
":plus:"	"â•" 
":minus:"	"â–" 
":divide:"	"â—" 
":infinity:"	"â™¾" 
":double_exclamation_mark:"	"â€¼" 
":exclamation_question_mark:"	"â‰" 
":red_question_mark:"	"â“" 
":white_question_mark:"	"â”" 
":white_exclamation_mark:"	"â•" 
":red_exclamation_mark:"	"â—" 
":wavy_dash:"	"ã€°" 
":currency_exchange:"	"ğŸ’±" 
":heavy_dollar_sign:"	"ğŸ’²" 
":medical_symbol:"	"âš•" 
":recycling_symbol:"	"â™»" 
":fleur_de_lis:"	"âšœ" 
":trident_emblem:"	"ğŸ”±" 
":name_badge:"	"ğŸ“›" 
":japanese_symbol_for_beginner:"	"ğŸ”°" 
":hollow_red_circle:"	"â­•" 
":check_mark_button:"	"âœ…" 
":check_box_with_check:"	"â˜‘" 
":check_mark:"	"âœ”" 
":cross_mark:"	"âŒ" 
":cross_mark_button:"	"â" 
":curly_loop:"	"â°" 
":double_curly_loop:"	"â¿" 
":part_alternation_mark:"	"ã€½" 
":eight_spoked_asterisk:"	"âœ³" 
":eight_pointed_star:"	"âœ´" 
":sparkle:"	"â‡" 
":copyright:"	"Â©" 
":registered:"	"Â®" 
":trade_mark:"	"â„¢" 
":red_circle:"	"ğŸ”´" 
":orange_circle:"	"ğŸŸ " 
":yellow_circle:"	"ğŸŸ¡" 
":green_circle:"	"ğŸŸ¢" 
":blue_circle:"	"ğŸ”µ" 
":purple_circle:"	"ğŸŸ£" 
":brown_circle:"	"ğŸŸ¤" 
":black_circle:"	"âš«" 
":white_circle:"	"âšª" 
":red_square:"	"ğŸŸ¥" 
":orange_square:"	"ğŸŸ§" 
":yellow_square:"	"ğŸŸ¨" 
":green_square:"	"ğŸŸ©" 
":blue_square:"	"ğŸŸ¦" 
":purple_square:"	"ğŸŸª" 
":brown_square:"	"ğŸŸ«" 
":black_large_square:"	"â¬›" 
":white_large_square:"	"â¬œ" 
":black_medium_square:"	"â—¼" 
":white_medium_square:"	"â—»" 
":black_medium_small_square:"	"â—¾" 
":white_medium_small_square:"	"â—½" 
":black_small_square:"	"â–ª" 
":white_small_square:"	"â–«" 
":large_orange_diamond:"	"ğŸ”¶" 
":large_blue_diamond:"	"ğŸ”·" 
":small_orange_diamond:"	"ğŸ”¸" 
":small_blue_diamond:"	"ğŸ”¹" 
":red_triangle_pointed_up:"	"ğŸ”º" 
":red_triangle_pointed_down:"	"ğŸ”»" 
":diamond_with_a_dot:"	"ğŸ’ " 
":radio_button:"	"ğŸ”˜" 
":white_square_button:"	"ğŸ”³" 
":black_square_button:"	"ğŸ”²" 
":chequered_flag:"	"ğŸ" 
":triangular_flag:"	"ğŸš©" 
":crossed_flags:"	"ğŸŒ" 
":black_flag:"	"ğŸ´" 
":white_flag:"	"ğŸ³" 
":rainbow_flag:"	"ğŸ³â€ğŸŒˆ" 
":transgender_flag:"	"ğŸ³â€âš§" 
":pirate_flag:"	"ğŸ´â€â˜ " 
Category:	<div 
Category:	YouTube
":yt:"	"yt" 
":oops:"	"oops" 
":buffering:"	"buffering" 
":stayhome:"	"stayhome" 
":dothefive:"	"dothefive" 
":elbowbump:"	"elbowbump" 
":goodvibes:"	"goodvibes" 
":thanksdoc:"	"thanksdoc" 
":videocall:"	"videocall" 
":virtualhug:"	"virtualhug" 
":yougotthis:"	"yougotthis" 
":sanitizer:"	"sanitizer" 
":takeout:"	"takeout" 
":hydrate:"	"hydrate" 
":chillwcat:"	"chillwcat" 
":chillwdog:"	"chillwdog" 
":elbowcough:"	"elbowcough" 
":learning:"	"learning" 
":washhands:"	"washhands" 
":socialdist:"	"socialdist" 
":shelterin:"	"shelterin" 

Category:	People
":grinning_face:"	"ğŸ˜€" 
":grinning_face_with_big_eyes:"	"ğŸ˜ƒ" 
":grinning_face_with_smiling_eyes:"	"ğŸ˜„" 
":beaming_face_with_smiling_eyes:"	"ğŸ˜" 
":grinning_squinting_face:"	"ğŸ˜†" 
":grinning_face_with_sweat:"	"ğŸ˜…" 
":rolling_on_the_floor_laughing:"	"ğŸ¤£" 
":face_with_tears_of_joy:"	"ğŸ˜‚" 
":slightly_smiling_face:"	"ğŸ™‚" 
":upside_down_face:"	"ğŸ™ƒ" 
":winking_face:"	"ğŸ˜‰" 
":smiling_face_with_smiling_eyes:"	"ğŸ˜Š" 
":smiling_face_with_halo:"	"ğŸ˜‡" 
":smiling_face_with_hearts:"	"ğŸ¥°" 
":smiling_face_with_heart_eyes:"	"ğŸ˜" 
":star_struck:"	"ğŸ¤©" 
":face_blowing_a_kiss:"	"ğŸ˜˜" 
":kissing_face:"	"ğŸ˜—" 
":smiling_face:"	"â˜º" 
":kissing_face_with_closed_eyes:"	"ğŸ˜š" 
":kissing_face_with_smiling_eyes:"	"ğŸ˜™" 
":smiling_face_with_tear:"	"ğŸ¥²" 
":face_savoring_food:"	"ğŸ˜‹" 
":face_with_tongue:"	"ğŸ˜›" 
":winking_face_with_tongue:"	"ğŸ˜œ" 
":zany_face:"	"ğŸ¤ª" 
":squinting_face_with_tongue:"	"ğŸ˜" 
":money_mouth_face:"	"ğŸ¤‘" 
":hugging_face:"	"ğŸ¤—" 
":face_with_hand_over_mouth:"	"ğŸ¤­" 
":shushing_face:"	"ğŸ¤«" 
":thinking_face:"	"ğŸ¤”" 
":zipper_mouth_face:"	"ğŸ¤" 
":face_with_raised_eyebrow:"	"ğŸ¤¨" 
":neutral_face:"	"ğŸ˜" 
":expressionless_face:"	"ğŸ˜‘" 
":face_without_mouth:"	"ğŸ˜¶" 
":face_in_clouds:"	"ğŸ˜¶â€ğŸŒ«" 
":smirking_face:"	"ğŸ˜" 
":unamused_face:"	"ğŸ˜’" 
":face_with_rolling_eyes:"	"ğŸ™„" 
":grimacing_face:"	"ğŸ˜¬" 
":face_exhaling:"	"ğŸ˜®â€ğŸ’¨" 
":lying_face:"	"ğŸ¤¥" 
":relieved_face:"	"ğŸ˜Œ" 
":pensive_face:"	"ğŸ˜”" 
":sleepy_face:"	"ğŸ˜ª" 
":drooling_face:"	"ğŸ¤¤" 
":sleeping_face:"	"ğŸ˜´" 
":face_with_medical_mask:"	"ğŸ˜·" 
":face_with_thermometer:"	"ğŸ¤’" 
":face_with_head_bandage:"	"ğŸ¤•" 
":nauseated_face:"	"ğŸ¤¢" 
":face_vomiting:"	"ğŸ¤®" 
":sneezing_face:"	"ğŸ¤§" 
":hot_face:"	"ğŸ¥µ" 
":cold_face:"	"ğŸ¥¶" 
":woozy_face:"	"ğŸ¥´" 
":knocked_out_face:"	"ğŸ˜µ" 
":face_with_spiral_eyes:"	"ğŸ˜µâ€ğŸ’«" 
":exploding_head:"	"ğŸ¤¯" 
":cowboy_hat_face:"	"ğŸ¤ " 
":partying_face:"	"ğŸ¥³" 
":disguised_face:"	"ğŸ¥¸" 
":smiling_face_with_sunglasses:"	"ğŸ˜" 
":nerd_face:"	"ğŸ¤“" 
":face_with_monocle:"	"ğŸ§" 
":confused_face:"	"ğŸ˜•" 
":worried_face:"	"ğŸ˜Ÿ" 
":slightly_frowning_face:"	"ğŸ™" 
":frowning_face:"	"â˜¹" 
":face_with_open_mouth:"	"ğŸ˜®" 
":hushed_face:"	"ğŸ˜¯" 
":astonished_face:"	"ğŸ˜²" 
":flushed_face:"	"ğŸ˜³" 
":pleading_face:"	"ğŸ¥º" 
":frowning_face_with_open_mouth:"	"ğŸ˜¦" 
":anguished_face:"	"ğŸ˜§" 
":fearful_face:"	"ğŸ˜¨" 
":anxious_face_with_sweat:"	"ğŸ˜°" 
":sad_but_relieved_face:"	"ğŸ˜¥" 
":crying_face:"	"ğŸ˜¢" 
":loudly_crying_face:"	"ğŸ˜­" 
":face_screaming_in_fear:"	"ğŸ˜±" 
":confounded_face:"	"ğŸ˜–" 
":persevering_face:"	"ğŸ˜£" 
":disappointed_face:"	"ğŸ˜" 
":downcast_face_with_sweat:"	"ğŸ˜“" 
":weary_face:"	"ğŸ˜©" 
":tired_face:"	"ğŸ˜«" 
":yawning_face:"	"ğŸ¥±" 
":face_with_steam_from_nose:"	"ğŸ˜¤" 
":pouting_face:"	"ğŸ˜¡" 
":angry_face:"	"ğŸ˜ " 
":face_with_symbols_on_mouth:"	"ğŸ¤¬" 
":smiling_face_with_horns:"	"ğŸ˜ˆ" 
":angry_face_with_horns:"	"ğŸ‘¿" 
":skull:"	"ğŸ’€" 
":skull_and_crossbones:"	"â˜ " 
":pile_of_poo:"	"ğŸ’©" 
":clown_face:"	"ğŸ¤¡" 
":ogre:"	"ğŸ‘¹" 
":goblin:"	"ğŸ‘º" 
":ghost:"	"ğŸ‘»" 
":alien:"	"ğŸ‘½" 
":alien_monster:"	"ğŸ‘¾" 
":robot:"	"ğŸ¤–" 
":grinning_cat:"	"ğŸ˜º" 
":grinning_cat_with_smiling_eyes:"	"ğŸ˜¸" 
":cat_with_tears_of_joy:"	"ğŸ˜¹" 
":smiling_cat_with_heart_eyes:"	"ğŸ˜»" 
":cat_with_wry_smile:"	"ğŸ˜¼" 
":kissing_cat:"	"ğŸ˜½" 
":weary_cat:"	"ğŸ™€" 
":crying_cat:"	"ğŸ˜¿" 
":pouting_cat:"	"ğŸ˜¾" 
":see_no_evil_monkey:"	"ğŸ™ˆ" 
":hear_no_evil_monkey:"	"ğŸ™‰" 
":speak_no_evil_monkey:"	"ğŸ™Š" 
":kiss:"	"ğŸ’‹" 
":love_letter:"	"ğŸ’Œ" 
":heart_with_arrow:"	"ğŸ’˜" 
":heart_with_ribbon:"	"ğŸ’" 
":sparkling_heart:"	"ğŸ’–" 
":growing_heart:"	"ğŸ’—" 
":beating_heart:"	"ğŸ’“" 
":revolving_hearts:"	"ğŸ’" 
":two_hearts:"	"ğŸ’•" 
":heart_decoration:"	"ğŸ’Ÿ" 
":heart_exclamation:"	"â£" 
":broken_heart:"	"ğŸ’”" 
":heart_on_fire:"	"â¤â€ğŸ”¥" 
":mending_heart:"	"â¤â€ğŸ©¹" 
":red_heart:"	"â¤" 
":orange_heart:"	"ğŸ§¡" 
":yellow_heart:"	"ğŸ’›" 
":green_heart:"	"ğŸ’š" 
":blue_heart:"	"ğŸ’™" 
":purple_heart:"	"ğŸ’œ" 
":brown_heart:"	"ğŸ¤" 
":black_heart:"	"ğŸ–¤" 
":white_heart:"	"ğŸ¤" 
":hundred_points:"	"ğŸ’¯" 
":anger_symbol:"	"ğŸ’¢" 
":collision:"	"ğŸ’¥" 
":dizzy:"	"ğŸ’«" 
":sweat_droplets:"	"ğŸ’¦" 
":dashing_away:"	"ğŸ’¨" 
":hole:"	"ğŸ•³" 
":bomb:"	"ğŸ’£" 
":speech_balloon:"	"ğŸ’¬" 
":eye_in_speech_bubble:"	"ğŸ‘â€ğŸ—¨" 
":left_speech_bubble:"	"ğŸ—¨" 
":right_anger_bubble:"	"ğŸ—¯" 
":thought_balloon:"	"ğŸ’­" 
":zzz:"	"ğŸ’¤" 
":waving_hand:"	"ğŸ‘‹" 
":raised_back_of_hand:"	"ğŸ¤š" 
":hand_with_fingers_splayed:"	"ğŸ–" 
":raised_hand:"	"âœ‹" 
":vulcan_salute:"	"ğŸ––" 
":ok_hand:"	"ğŸ‘Œ" 
":pinched_fingers:"	"ğŸ¤Œ" 
":pinching_hand:"	"ğŸ¤" 
":victory_hand:"	"âœŒ" 
":crossed_fingers:"	"ğŸ¤" 
":love_you_gesture:"	"ğŸ¤Ÿ" 
":sign_of_the_horns:"	"ğŸ¤˜" 
":call_me_hand:"	"ğŸ¤™" 
":backhand_index_pointing_left:"	"ğŸ‘ˆ" 
":backhand_index_pointing_right:"	"ğŸ‘‰" 
":backhand_index_pointing_up:"	"ğŸ‘†" 
":middle_finger:"	"ğŸ–•" 
":backhand_index_pointing_down:"	"ğŸ‘‡" 
":index_pointing_up:"	"â˜" 
":thumbs_up:"	"ğŸ‘" 
":thumbs_down:"	"ğŸ‘" 
":raised_fist:"	"âœŠ" 
":oncoming_fist:"	"ğŸ‘Š" 
":left_facing_fist:"	"ğŸ¤›" 
":right_facing_fist:"	"ğŸ¤œ" 
":clapping_hands:"	"ğŸ‘" 
":raising_hands:"	"ğŸ™Œ" 
":open_hands:"	"ğŸ‘" 
":palms_up_together:"	"ğŸ¤²" 
":handshake:"	"ğŸ¤" 
":folded_hands:"	"ğŸ™" 
":writing_hand:"	"âœ" 
":nail_polish:"	"ğŸ’…" 
":selfie:"	"ğŸ¤³" 
":flexed_biceps:"	"ğŸ’ª" 
":mechanical_arm:"	"ğŸ¦¾" 
":mechanical_leg:"	"ğŸ¦¿" 
":leg:"	"ğŸ¦µ" 
":foot:"	"ğŸ¦¶" 
":ear:"	"ğŸ‘‚" 
":ear_with_hearing_aid:"	"ğŸ¦»" 
":nose:"	"ğŸ‘ƒ" 
":brain:"	"ğŸ§ " 
":anatomical_heart:"	"ğŸ«€" 
":lungs:"	"ğŸ«" 
":tooth:"	"ğŸ¦·" 
":bone:"	"ğŸ¦´" 
":eyes:"	"ğŸ‘€" 
":eye:"	"ğŸ‘" 
":tongue:"	"ğŸ‘…" 
":mouth:"	"ğŸ‘„" 
":baby:"	"ğŸ‘¶" 
":child:"	"ğŸ§’" 
":boy:"	"ğŸ‘¦" 
":girl:"	"ğŸ‘§" 
":person:"	"ğŸ§‘" 
":person_blond_hair:"	"ğŸ‘±" 
":man:"	"ğŸ‘¨" 
":person_beard:"	"ğŸ§”" 
":man_beard:"	"ğŸ§”â€â™‚" 
":woman_beard:"	"ğŸ§”â€â™€" 
":woman:"	"ğŸ‘©" 
":woman_blond_hair:"	"ğŸ‘±â€â™€" 
":man_blond_hair:"	"ğŸ‘±â€â™‚" 
":older_person:"	"ğŸ§“" 
":old_man:"	"ğŸ‘´" 
":old_woman:"	"ğŸ‘µ" 
":person_frowning:"	"ğŸ™" 
":man_frowning:"	"ğŸ™â€â™‚" 
":woman_frowning:"	"ğŸ™â€â™€" 
":person_pouting:"	"ğŸ™" 
":man_pouting:"	"ğŸ™â€â™‚" 
":woman_pouting:"	"ğŸ™â€â™€" 
":person_gesturing_no:"	"ğŸ™…" 
":man_gesturing_no:"	"ğŸ™…â€â™‚" 
":woman_gesturing_no:"	"ğŸ™…â€â™€" 
":person_gesturing_ok:"	"ğŸ™†" 
":man_gesturing_ok:"	"ğŸ™†â€â™‚" 
":woman_gesturing_ok:"	"ğŸ™†â€â™€" 
":person_tipping_hand:"	"ğŸ’" 
":man_tipping_hand:"	"ğŸ’â€â™‚" 
":woman_tipping_hand:"	"ğŸ’â€â™€" 
":person_raising_hand:"	"ğŸ™‹" 
":man_raising_hand:"	"ğŸ™‹â€â™‚" 
":woman_raising_hand:"	"ğŸ™‹â€â™€" 
":deaf_person:"	"ğŸ§" 
":deaf_man:"	"ğŸ§â€â™‚" 
":deaf_woman:"	"ğŸ§â€â™€" 
":person_bowing:"	"ğŸ™‡" 
":man_bowing:"	"ğŸ™‡â€â™‚" 
":woman_bowing:"	"ğŸ™‡â€â™€" 
":person_facepalming:"	"ğŸ¤¦" 
":man_facepalming:"	"ğŸ¤¦â€â™‚" 
":woman_facepalming:"	"ğŸ¤¦â€â™€" 
":person_shrugging:"	"ğŸ¤·" 
":man_shrugging:"	"ğŸ¤·â€â™‚" 
":woman_shrugging:"	"ğŸ¤·â€â™€" 
":health_worker:"	"ğŸ§‘â€âš•" 
":man_health_worker:"	"ğŸ‘¨â€âš•" 
":woman_health_worker:"	"ğŸ‘©â€âš•" 
":student:"	"ğŸ§‘â€ğŸ“" 
":man_student:"	"ğŸ‘¨â€ğŸ“" 
":woman_student:"	"ğŸ‘©â€ğŸ“" 
":teacher:"	"ğŸ§‘â€ğŸ«" 
":man_teacher:"	"ğŸ‘¨â€ğŸ«" 
":woman_teacher:"	"ğŸ‘©â€ğŸ«" 
":judge:"	"ğŸ§‘â€âš–" 
":man_judge:"	"ğŸ‘¨â€âš–" 
":woman_judge:"	"ğŸ‘©â€âš–" 
":farmer:"	"ğŸ§‘â€ğŸŒ¾" 
":man_farmer:"	"ğŸ‘¨â€ğŸŒ¾" 
":woman_farmer:"	"ğŸ‘©â€ğŸŒ¾" 
":cook:"	"ğŸ§‘â€ğŸ³" 
":man_cook:"	"ğŸ‘¨â€ğŸ³" 
":woman_cook:"	"ğŸ‘©â€ğŸ³" 
":mechanic:"	"ğŸ§‘â€ğŸ”§" 
":man_mechanic:"	"ğŸ‘¨â€ğŸ”§" 
":woman_mechanic:"	"ğŸ‘©â€ğŸ”§" 
":factory_worker:"	"ğŸ§‘â€ğŸ­" 
":man_factory_worker:"	"ğŸ‘¨â€ğŸ­" 
":woman_factory_worker:"	"ğŸ‘©â€ğŸ­" 
":office_worker:"	"ğŸ§‘â€ğŸ’¼" 
":man_office_worker:"	"ğŸ‘¨â€ğŸ’¼" 
":woman_office_worker:"	"ğŸ‘©â€ğŸ’¼" 
":scientist:"	"ğŸ§‘â€ğŸ”¬" 
":man_scientist:"	"ğŸ‘¨â€ğŸ”¬" 
":woman_scientist:"	"ğŸ‘©â€ğŸ”¬" 
":technologist:"	"ğŸ§‘â€ğŸ’»" 
":man_technologist:"	"ğŸ‘¨â€ğŸ’»" 
":woman_technologist:"	"ğŸ‘©â€ğŸ’»" 
":singer:"	"ğŸ§‘â€ğŸ¤" 
":man_singer:"	"ğŸ‘¨â€ğŸ¤" 
":woman_singer:"	"ğŸ‘©â€ğŸ¤" 
":artist:"	"ğŸ§‘â€ğŸ¨" 
":man_artist:"	"ğŸ‘¨â€ğŸ¨" 
":woman_artist:"	"ğŸ‘©â€ğŸ¨" 
":pilot:"	"ğŸ§‘â€âœˆ" 
":man_pilot:"	"ğŸ‘¨â€âœˆ" 
":woman_pilot:"	"ğŸ‘©â€âœˆ" 
":astronaut:"	"ğŸ§‘â€ğŸš€" 
":man_astronaut:"	"ğŸ‘¨â€ğŸš€" 
":woman_astronaut:"	"ğŸ‘©â€ğŸš€" 
":firefighter:"	"ğŸ§‘â€ğŸš’" 
":man_firefighter:"	"ğŸ‘¨â€ğŸš’" 
":woman_firefighter:"	"ğŸ‘©â€ğŸš’" 
":police_officer:"	"ğŸ‘®" 
":man_police_officer:"	"ğŸ‘®â€â™‚" 
":woman_police_officer:"	"ğŸ‘®â€â™€" 
":detective:"	"ğŸ•µ" 
":man_detective:"	"ğŸ•µâ€â™‚" 
":woman_detective:"	"ğŸ•µâ€â™€" 
":guard:"	"ğŸ’‚" 
":man_guard:"	"ğŸ’‚â€â™‚" 
":woman_guard:"	"ğŸ’‚â€â™€" 
":ninja:"	"ğŸ¥·" 
":construction_worker:"	"ğŸ‘·" 
":man_construction_worker:"	"ğŸ‘·â€â™‚" 
":woman_construction_worker:"	"ğŸ‘·â€â™€" 
":prince:"	"ğŸ¤´" 
":princess:"	"ğŸ‘¸" 
":person_wearing_turban:"	"ğŸ‘³" 
":man_wearing_turban:"	"ğŸ‘³â€â™‚" 
":woman_wearing_turban:"	"ğŸ‘³â€â™€" 
":person_with_skullcap:"	"ğŸ‘²" 
":woman_with_headscarf:"	"ğŸ§•" 
":person_in_tuxedo:"	"ğŸ¤µ" 
":man_in_tuxedo:"	"ğŸ¤µâ€â™‚" 
":woman_in_tuxedo:"	"ğŸ¤µâ€â™€" 
":person_with_veil:"	"ğŸ‘°" 
":man_with_veil:"	"ğŸ‘°â€â™‚" 
":woman_with_veil:"	"ğŸ‘°â€â™€" 
":pregnant_woman:"	"ğŸ¤°" 
":breast_feeding:"	"ğŸ¤±" 
":woman_feeding_baby:"	"ğŸ‘©â€ğŸ¼" 
":man_feeding_baby:"	"ğŸ‘¨â€ğŸ¼" 
":person_feeding_baby:"	"ğŸ§‘â€ğŸ¼" 
":baby_angel:"	"ğŸ‘¼" 
":santa_claus:"	"ğŸ…" 
":mrs_claus:"	"ğŸ¤¶" 
":mx_claus:"	"ğŸ§‘â€ğŸ„" 
":superhero:"	"ğŸ¦¸" 
":man_superhero:"	"ğŸ¦¸â€â™‚" 
":woman_superhero:"	"ğŸ¦¸â€â™€" 
":supervillain:"	"ğŸ¦¹" 
":man_supervillain:"	"ğŸ¦¹â€â™‚" 
":woman_supervillain:"	"ğŸ¦¹â€â™€" 
":mage:"	"ğŸ§™" 
":man_mage:"	"ğŸ§™â€â™‚" 
":woman_mage:"	"ğŸ§™â€â™€" 
":fairy:"	"ğŸ§š" 
":man_fairy:"	"ğŸ§šâ€â™‚" 
":woman_fairy:"	"ğŸ§šâ€â™€" 
":vampire:"	"ğŸ§›" 
":man_vampire:"	"ğŸ§›â€â™‚" 
":woman_vampire:"	"ğŸ§›â€â™€" 
":merperson:"	"ğŸ§œ" 
":merman:"	"ğŸ§œâ€â™‚" 
":mermaid:"	"ğŸ§œâ€â™€" 
":elf:"	"ğŸ§" 
":man_elf:"	"ğŸ§â€â™‚" 
":woman_elf:"	"ğŸ§â€â™€" 
":genie:"	"ğŸ§" 
":man_genie:"	"ğŸ§â€â™‚" 
":woman_genie:"	"ğŸ§â€â™€" 
":zombie:"	"ğŸ§Ÿ" 
":man_zombie:"	"ğŸ§Ÿâ€â™‚" 
":woman_zombie:"	"ğŸ§Ÿâ€â™€" 
":person_getting_massage:"	"ğŸ’†" 
":man_getting_massage:"	"ğŸ’†â€â™‚" 
":woman_getting_massage:"	"ğŸ’†â€â™€" 
":person_getting_haircut:"	"ğŸ’‡" 
":man_getting_haircut:"	"ğŸ’‡â€â™‚" 
":woman_getting_haircut:"	"ğŸ’‡â€â™€" 
":person_walking:"	"ğŸš¶" 
":man_walking:"	"ğŸš¶â€â™‚" 
":woman_walking:"	"ğŸš¶â€â™€" 
":person_standing:"	"ğŸ§" 
":man_standing:"	"ğŸ§â€â™‚" 
":woman_standing:"	"ğŸ§â€â™€" 
":person_kneeling:"	"ğŸ§" 
":man_kneeling:"	"ğŸ§â€â™‚" 
":woman_kneeling:"	"ğŸ§â€â™€" 
":person_with_white_cane:"	"ğŸ§‘â€ğŸ¦¯" 
":man_with_white_cane:"	"ğŸ‘¨â€ğŸ¦¯" 
":woman_with_white_cane:"	"ğŸ‘©â€ğŸ¦¯" 
":person_in_motorized_wheelchair:"	"ğŸ§‘â€ğŸ¦¼" 
":man_in_motorized_wheelchair:"	"ğŸ‘¨â€ğŸ¦¼" 
":woman_in_motorized_wheelchair:"	"ğŸ‘©â€ğŸ¦¼" 
":person_in_manual_wheelchair:"	"ğŸ§‘â€ğŸ¦½" 
":man_in_manual_wheelchair:"	"ğŸ‘¨â€ğŸ¦½" 
":woman_in_manual_wheelchair:"	"ğŸ‘©â€ğŸ¦½" 
":person_running:"	"ğŸƒ" 
":man_running:"	"ğŸƒâ€â™‚" 
":woman_running:"	"ğŸƒâ€â™€" 
":woman_dancing:"	"ğŸ’ƒ" 
":man_dancing:"	"ğŸ•º" 
":person_in_suit_levitating:"	"ğŸ•´" 
":people_with_bunny_ears:"	"ğŸ‘¯" 
":men_with_bunny_ears:"	"ğŸ‘¯â€â™‚" 
":women_with_bunny_ears:"	"ğŸ‘¯â€â™€" 
":person_in_steamy_room:"	"ğŸ§–" 
":man_in_steamy_room:"	"ğŸ§–â€â™‚" 
":woman_in_steamy_room:"	"ğŸ§–â€â™€" 
":person_climbing:"	"ğŸ§—" 
":man_climbing:"	"ğŸ§—â€â™‚" 
":woman_climbing:"	"ğŸ§—â€â™€" 
":person_fencing:"	"ğŸ¤º" 
":horse_racing:"	"ğŸ‡" 
":skier:"	"â›·" 
":snowboarder:"	"ğŸ‚" 
":person_golfing:"	"ğŸŒ" 
":man_golfing:"	"ğŸŒâ€â™‚" 
":woman_golfing:"	"ğŸŒâ€â™€" 
":person_surfing:"	"ğŸ„" 
":man_surfing:"	"ğŸ„â€â™‚" 
":woman_surfing:"	"ğŸ„â€â™€" 
":person_rowing_boat:"	"ğŸš£" 
":man_rowing_boat:"	"ğŸš£â€â™‚" 
":woman_rowing_boat:"	"ğŸš£â€â™€" 
":person_swimming:"	"ğŸŠ" 
":man_swimming:"	"ğŸŠâ€â™‚" 
":woman_swimming:"	"ğŸŠâ€â™€" 
":person_bouncing_ball:"	"â›¹" 
":man_bouncing_ball:"	"â›¹â€â™‚" 
":woman_bouncing_ball:"	"â›¹â€â™€" 
":person_lifting_weights:"	"ğŸ‹" 
":man_lifting_weights:"	"ğŸ‹â€â™‚" 
":woman_lifting_weights:"	"ğŸ‹â€â™€" 
":person_biking:"	"ğŸš´" 
":man_biking:"	"ğŸš´â€â™‚" 
":woman_biking:"	"ğŸš´â€â™€" 
":person_mountain_biking:"	"ğŸšµ" 
":man_mountain_biking:"	"ğŸšµâ€â™‚" 
":woman_mountain_biking:"	"ğŸšµâ€â™€" 
":person_cartwheeling:"	"ğŸ¤¸" 
":man_cartwheeling:"	"ğŸ¤¸â€â™‚" 
":woman_cartwheeling:"	"ğŸ¤¸â€â™€" 
":people_wrestling:"	"ğŸ¤¼" 
":men_wrestling:"	"ğŸ¤¼â€â™‚" 
":women_wrestling:"	"ğŸ¤¼â€â™€" 
":person_playing_water_polo:"	"ğŸ¤½" 
":man_playing_water_polo:"	"ğŸ¤½â€â™‚" 
":woman_playing_water_polo:"	"ğŸ¤½â€â™€" 
":person_playing_handball:"	"ğŸ¤¾" 
":man_playing_handball:"	"ğŸ¤¾â€â™‚" 
":woman_playing_handball:"	"ğŸ¤¾â€â™€" 
":person_juggling:"	"ğŸ¤¹" 
":man_juggling:"	"ğŸ¤¹â€â™‚" 
":woman_juggling:"	"ğŸ¤¹â€â™€" 
":person_in_lotus_position:"	"ğŸ§˜" 
":man_in_lotus_position:"	"ğŸ§˜â€â™‚" 
":woman_in_lotus_position:"	"ğŸ§˜â€â™€" 
":person_taking_bath:"	"ğŸ›€" 
":person_in_bed:"	"ğŸ›Œ" 
":people_holding_hands:"	"ğŸ§‘â€ğŸ¤â€ğŸ§‘" 
":women_holding_hands:"	"ğŸ‘­" 
":woman_and_man_holding_hands:"	"ğŸ‘«" 
":men_holding_hands:"	"ğŸ‘¬" 
":couplekiss:"	"ğŸ’" 
":kiss_woman_man:"	"ğŸ‘©â€â¤â€ğŸ’‹â€ğŸ‘¨" 
":kiss_man_man:"	"ğŸ‘¨â€â¤â€ğŸ’‹â€ğŸ‘¨" 
":kiss_woman_woman:"	"ğŸ‘©â€â¤â€ğŸ’‹â€ğŸ‘©" 
":couple_with_heart:"	"ğŸ’‘" 
":couple_with_heart_woman_man:"	"ğŸ‘©â€â¤â€ğŸ‘¨" 
":couple_with_heart_man_man:"	"ğŸ‘¨â€â¤â€ğŸ‘¨" 
":couple_with_heart_woman_woman:"	"ğŸ‘©â€â¤â€ğŸ‘©" 
":family:"	"ğŸ‘ª" 
":family_man_woman_boy:"	"ğŸ‘¨â€ğŸ‘©â€ğŸ‘¦" 
":family_man_woman_girl:"	"ğŸ‘¨â€ğŸ‘©â€ğŸ‘§" 
":family_man_woman_girl_boy:"	"ğŸ‘¨â€ğŸ‘©â€ğŸ‘§â€ğŸ‘¦" 
":family_man_woman_boy_boy:"	"ğŸ‘¨â€ğŸ‘©â€ğŸ‘¦â€ğŸ‘¦" 
":family_man_woman_girl_girl:"	"ğŸ‘¨â€ğŸ‘©â€ğŸ‘§â€ğŸ‘§" 
":family_man_man_boy:"	"ğŸ‘¨â€ğŸ‘¨â€ğŸ‘¦" 
":family_man_man_girl:"	"ğŸ‘¨â€ğŸ‘¨â€ğŸ‘§" 
":family_man_man_girl_boy:"	"ğŸ‘¨â€ğŸ‘¨â€ğŸ‘§â€ğŸ‘¦" 
":family_man_man_boy_boy:"	"ğŸ‘¨â€ğŸ‘¨â€ğŸ‘¦â€ğŸ‘¦" 
":family_man_man_girl_girl:"	"ğŸ‘¨â€ğŸ‘¨â€ğŸ‘§â€ğŸ‘§" 
":family_woman_woman_boy:"	"ğŸ‘©â€ğŸ‘©â€ğŸ‘¦" 
":family_woman_woman_girl:"	"ğŸ‘©â€ğŸ‘©â€ğŸ‘§" 
":family_woman_woman_girl_boy:"	"ğŸ‘©â€ğŸ‘©â€ğŸ‘§â€ğŸ‘¦" 
":family_woman_woman_boy_boy:"	"ğŸ‘©â€ğŸ‘©â€ğŸ‘¦â€ğŸ‘¦" 
":family_woman_woman_girl_girl:"	"ğŸ‘©â€ğŸ‘©â€ğŸ‘§â€ğŸ‘§" 
":family_man_boy:"	"ğŸ‘¨â€ğŸ‘¦" 
":family_man_boy_boy:"	"ğŸ‘¨â€ğŸ‘¦â€ğŸ‘¦" 
":family_man_girl:"	"ğŸ‘¨â€ğŸ‘§" 
":family_man_girl_boy:"	"ğŸ‘¨â€ğŸ‘§â€ğŸ‘¦" 
":family_man_girl_girl:"	"ğŸ‘¨â€ğŸ‘§â€ğŸ‘§" 
":family_woman_boy:"	"ğŸ‘©â€ğŸ‘¦" 
":family_woman_boy_boy:"	"ğŸ‘©â€ğŸ‘¦â€ğŸ‘¦" 
":family_woman_girl:"	"ğŸ‘©â€ğŸ‘§" 
":family_woman_girl_boy:"	"ğŸ‘©â€ğŸ‘§â€ğŸ‘¦" 
":family_woman_girl_girl:"	"ğŸ‘©â€ğŸ‘§â€ğŸ‘§" 
":speaking_head:"	"ğŸ—£" 
":bust_in_silhouette:"	"ğŸ‘¤" 
":busts_in_silhouette:"	"ğŸ‘¥" 
":people_hugging:"	"ğŸ«‚" 
":footprints:"	"ğŸ‘£" 

Category:	Nature
":monkey_face:"	"ğŸµ" 
":monkey:"	"ğŸ’" 
":gorilla:"	"ğŸ¦" 
":orangutan:"	"ğŸ¦§" 
":dog:"	"ğŸ¶" 
":dog2:"	"ğŸ•" 
":guide_dog:"	"ğŸ¦®" 
":service_dog:"	"ğŸ•â€ğŸ¦º" 
":poodle:"	"ğŸ©" 
":wolf:"	"ğŸº" 
":fox:"	"ğŸ¦Š" 
":raccoon:"	"ğŸ¦" 
":cat:"	"ğŸ±" 
":cat2:"	"ğŸˆ" 
":black_cat:"	"ğŸˆâ€â¬›" 
":lion:"	"ğŸ¦" 
":tiger:"	"ğŸ¯" 
":tiger2:"	"ğŸ…" 
":leopard:"	"ğŸ†" 
":horse:"	"ğŸ´" 
":racehorse:"	"ğŸ" 
":unicorn:"	"ğŸ¦„" 
":zebra:"	"ğŸ¦“" 
":deer:"	"ğŸ¦Œ" 
":bison:"	"ğŸ¦¬" 
":cow:"	"ğŸ®" 
":ox:"	"ğŸ‚" 
":water_buffalo:"	"ğŸƒ" 
":cow2:"	"ğŸ„" 
":pig:"	"ğŸ·" 
":pig2:"	"ğŸ–" 
":boar:"	"ğŸ—" 
":pig_nose:"	"ğŸ½" 
":ram:"	"ğŸ" 
":ewe:"	"ğŸ‘" 
":goat:"	"ğŸ" 
":dromedary_camel:"	"ğŸª" 
":camel:"	"ğŸ«" 
":llama:"	"ğŸ¦™" 
":giraffe:"	"ğŸ¦’" 
":elephant:"	"ğŸ˜" 
":mammoth:"	"ğŸ¦£" 
":rhinoceros:"	"ğŸ¦" 
":hippopotamus:"	"ğŸ¦›" 
":mouse:"	"ğŸ­" 
":mouse2:"	"ğŸ" 
":rat:"	"ğŸ€" 
":hamster:"	"ğŸ¹" 
":rabbit:"	"ğŸ°" 
":rabbit2:"	"ğŸ‡" 
":chipmunk:"	"ğŸ¿" 
":beaver:"	"ğŸ¦«" 
":hedgehog:"	"ğŸ¦”" 
":bat:"	"ğŸ¦‡" 
":bear:"	"ğŸ»" 
":polar_bear:"	"ğŸ»â€â„" 
":koala:"	"ğŸ¨" 
":panda:"	"ğŸ¼" 
":sloth:"	"ğŸ¦¥" 
":otter:"	"ğŸ¦¦" 
":skunk:"	"ğŸ¦¨" 
":kangaroo:"	"ğŸ¦˜" 
":badger:"	"ğŸ¦¡" 
":paw_prints:"	"ğŸ¾" 
":turkey:"	"ğŸ¦ƒ" 
":chicken:"	"ğŸ”" 
":rooster:"	"ğŸ“" 
":hatching_chick:"	"ğŸ£" 
":baby_chick:"	"ğŸ¤" 
":front_facing_baby_chick:"	"ğŸ¥" 
":bird:"	"ğŸ¦" 
":penguin:"	"ğŸ§" 
":dove:"	"ğŸ•Š" 
":eagle:"	"ğŸ¦…" 
":duck:"	"ğŸ¦†" 
":swan:"	"ğŸ¦¢" 
":owl:"	"ğŸ¦‰" 
":dodo:"	"ğŸ¦¤" 
":feather:"	"ğŸª¶" 
":flamingo:"	"ğŸ¦©" 
":peacock:"	"ğŸ¦š" 
":parrot:"	"ğŸ¦œ" 
":frog:"	"ğŸ¸" 
":crocodile:"	"ğŸŠ" 
":turtle:"	"ğŸ¢" 
":lizard:"	"ğŸ¦" 
":snake:"	"ğŸ" 
":dragon_face:"	"ğŸ²" 
":dragon:"	"ğŸ‰" 
":sauropod:"	"ğŸ¦•" 
":t_rex:"	"ğŸ¦–" 
":spouting_whale:"	"ğŸ³" 
":whale2:"	"ğŸ‹" 
":dolphin:"	"ğŸ¬" 
":seal:"	"ğŸ¦­" 
":fish:"	"ğŸŸ" 
":tropical_fish:"	"ğŸ " 
":blowfish:"	"ğŸ¡" 
":shark:"	"ğŸ¦ˆ" 
":octopus:"	"ğŸ™" 
":spiral_shell:"	"ğŸš" 
":snail:"	"ğŸŒ" 
":butterfly:"	"ğŸ¦‹" 
":bug:"	"ğŸ›" 
":ant:"	"ğŸœ" 
":honeybee:"	"ğŸ" 
":beetle:"	"ğŸª²" 
":lady_beetle:"	"ğŸ" 
":cricket:"	"ğŸ¦—" 
":cockroach:"	"ğŸª³" 
":spider:"	"ğŸ•·" 
":spider_web:"	"ğŸ•¸" 
":scorpion:"	"ğŸ¦‚" 
":mosquito:"	"ğŸ¦Ÿ" 
":fly:"	"ğŸª°" 
":worm:"	"ğŸª±" 
":microbe:"	"ğŸ¦ " 
":bouquet:"	"ğŸ’" 
":cherry_blossom:"	"ğŸŒ¸" 
":white_flower:"	"ğŸ’®" 
":rosette:"	"ğŸµ" 
":rose:"	"ğŸŒ¹" 
":wilted_flower:"	"ğŸ¥€" 
":hibiscus:"	"ğŸŒº" 
":sunflower:"	"ğŸŒ»" 
":blossom:"	"ğŸŒ¼" 
":tulip:"	"ğŸŒ·" 
":seedling:"	"ğŸŒ±" 
":potted_plant:"	"ğŸª´" 
":evergreen_tree:"	"ğŸŒ²" 
":deciduous_tree:"	"ğŸŒ³" 
":palm_tree:"	"ğŸŒ´" 
":cactus:"	"ğŸŒµ" 
":sheaf_of_rice:"	"ğŸŒ¾" 
":herb:"	"ğŸŒ¿" 
":shamrock:"	"â˜˜" 
":four_leaf_clover:"	"ğŸ€" 
":maple_leaf:"	"ğŸ" 
":fallen_leaf:"	"ğŸ‚" 
":leaf_fluttering_in_wind:"	"ğŸƒ" 

Category:	Food
":grapes:"	"ğŸ‡" 
":melon:"	"ğŸˆ" 
":watermelon:"	"ğŸ‰" 
":tangerine:"	"ğŸŠ" 
":lemon:"	"ğŸ‹" 
":banana:"	"ğŸŒ" 
":pineapple:"	"ğŸ" 
":mango:"	"ğŸ¥­" 
":red_apple:"	"ğŸ" 
":green_apple:"	"ğŸ" 
":pear:"	"ğŸ" 
":peach:"	"ğŸ‘" 
":cherries:"	"ğŸ’" 
":strawberry:"	"ğŸ“" 
":blueberries:"	"ğŸ«" 
":kiwi_fruit:"	"ğŸ¥" 
":tomato:"	"ğŸ…" 
":olive:"	"ğŸ«’" 
":coconut:"	"ğŸ¥¥" 
":avocado:"	"ğŸ¥‘" 
":eggplant:"	"ğŸ†" 
":potato:"	"ğŸ¥”" 
":carrot:"	"ğŸ¥•" 
":ear_of_corn:"	"ğŸŒ½" 
":hot_pepper:"	"ğŸŒ¶" 
":bell_pepper:"	"ğŸ«‘" 
":cucumber:"	"ğŸ¥’" 
":leafy_green:"	"ğŸ¥¬" 
":broccoli:"	"ğŸ¥¦" 
":garlic:"	"ğŸ§„" 
":onion:"	"ğŸ§…" 
":mushroom:"	"ğŸ„" 
":peanuts:"	"ğŸ¥œ" 
":chestnut:"	"ğŸŒ°" 
":bread:"	"ğŸ" 
":croissant:"	"ğŸ¥" 
":baguette_bread:"	"ğŸ¥–" 
":flatbread:"	"ğŸ«“" 
":pretzel:"	"ğŸ¥¨" 
":bagel:"	"ğŸ¥¯" 
":pancakes:"	"ğŸ¥" 
":waffle:"	"ğŸ§‡" 
":cheese_wedge:"	"ğŸ§€" 
":meat_on_bone:"	"ğŸ–" 
":poultry_leg:"	"ğŸ—" 
":cut_of_meat:"	"ğŸ¥©" 
":bacon:"	"ğŸ¥“" 
":hamburger:"	"ğŸ”" 
":french_fries:"	"ğŸŸ" 
":pizza:"	"ğŸ•" 
":hot_dog:"	"ğŸŒ­" 
":sandwich:"	"ğŸ¥ª" 
":taco:"	"ğŸŒ®" 
":burrito:"	"ğŸŒ¯" 
":tamale:"	"ğŸ«”" 
":stuffed_flatbread:"	"ğŸ¥™" 
":falafel:"	"ğŸ§†" 
":egg2:"	"ğŸ¥š" 
":cooking:"	"ğŸ³" 
":shallow_pan_of_food:"	"ğŸ¥˜" 
":pot_of_food:"	"ğŸ²" 
":fondue:"	"ğŸ«•" 
":bowl_with_spoon:"	"ğŸ¥£" 
":green_salad:"	"ğŸ¥—" 
":popcorn:"	"ğŸ¿" 
":butter:"	"ğŸ§ˆ" 
":salt:"	"ğŸ§‚" 
":canned_food:"	"ğŸ¥«" 
":bento_box:"	"ğŸ±" 
":rice_cracker:"	"ğŸ˜" 
":rice_ball:"	"ğŸ™" 
":cooked_rice:"	"ğŸš" 
":curry_rice:"	"ğŸ›" 
":steaming_bowl:"	"ğŸœ" 
":spaghetti:"	"ğŸ" 
":roasted_sweet_potato:"	"ğŸ " 
":oden:"	"ğŸ¢" 
":sushi:"	"ğŸ£" 
":fried_shrimp:"	"ğŸ¤" 
":fish_cake_with_swirl:"	"ğŸ¥" 
":moon_cake:"	"ğŸ¥®" 
":dango:"	"ğŸ¡" 
":dumpling:"	"ğŸ¥Ÿ" 
":fortune_cookie:"	"ğŸ¥ " 
":takeout_box:"	"ğŸ¥¡" 
":crab:"	"ğŸ¦€" 
":lobster:"	"ğŸ¦" 
":shrimp:"	"ğŸ¦" 
":squid:"	"ğŸ¦‘" 
":oyster:"	"ğŸ¦ª" 
":soft_ice_cream:"	"ğŸ¦" 
":shaved_ice:"	"ğŸ§" 
":ice_cream:"	"ğŸ¨" 
":doughnut:"	"ğŸ©" 
":cookie:"	"ğŸª" 
":birthday_cake:"	"ğŸ‚" 
":shortcake:"	"ğŸ°" 
":cupcake:"	"ğŸ§" 
":pie:"	"ğŸ¥§" 
":chocolate_bar:"	"ğŸ«" 
":candy:"	"ğŸ¬" 
":lollipop:"	"ğŸ­" 
":custard:"	"ğŸ®" 
":honey_pot:"	"ğŸ¯" 
":baby_bottle:"	"ğŸ¼" 
":glass_of_milk:"	"ğŸ¥›" 
":hot_beverage:"	"â˜•" 
":teapot:"	"ğŸ«–" 
":teacup_without_handle:"	"ğŸµ" 
":sake:"	"ğŸ¶" 
":bottle_with_popping_cork:"	"ğŸ¾" 
":wine_glass:"	"ğŸ·" 
":cocktail_glass:"	"ğŸ¸" 
":tropical_drink:"	"ğŸ¹" 
":beer_mug:"	"ğŸº" 
":clinking_beer_mugs:"	"ğŸ»" 
":clinking_glasses:"	"ğŸ¥‚" 
":tumbler_glass:"	"ğŸ¥ƒ" 
":cup_with_straw:"	"ğŸ¥¤" 
":bubble_tea:"	"ğŸ§‹" 
":beverage_box:"	"ğŸ§ƒ" 
":mate:"	"ğŸ§‰" 
":ice:"	"ğŸ§Š" 
":chopsticks:"	"ğŸ¥¢" 
":fork_and_knife_with_plate:"	"ğŸ½" 
":fork_and_knife:"	"ğŸ´" 
":spoon:"	"ğŸ¥„" 
":kitchen_knife:"	"ğŸ”ª" 
":amphora:"	"ğŸº" 

Category:	Travel
":globe_showing_europe_africa:"	"ğŸŒ" 
":globe_showing_americas:"	"ğŸŒ" 
":globe_showing_asia_australia:"	"ğŸŒ" 
":globe_with_meridians:"	"ğŸŒ" 
":world_map:"	"ğŸ—º" 
":map_of_japan:"	"ğŸ—¾" 
":compass:"	"ğŸ§­" 
":snow_capped_mountain:"	"ğŸ”" 
":mountain:"	"â›°" 
":volcano:"	"ğŸŒ‹" 
":mount_fuji:"	"ğŸ—»" 
":camping:"	"ğŸ•" 
":beach_with_umbrella:"	"ğŸ–" 
":desert:"	"ğŸœ" 
":desert_island:"	"ğŸ" 
":national_park:"	"ğŸ" 
":stadium:"	"ğŸŸ" 
":classical_building:"	"ğŸ›" 
":building_construction:"	"ğŸ—" 
":brick:"	"ğŸ§±" 
":rock:"	"ğŸª¨" 
":wood:"	"ğŸªµ" 
":hut:"	"ğŸ›–" 
":houses:"	"ğŸ˜" 
":derelict_house:"	"ğŸš" 
":house:"	"ğŸ " 
":house_with_garden:"	"ğŸ¡" 
":office_building:"	"ğŸ¢" 
":japanese_post_office:"	"ğŸ£" 
":european_post_office:"	"ğŸ¤" 
":hospital:"	"ğŸ¥" 
":bank:"	"ğŸ¦" 
":hotel:"	"ğŸ¨" 
":love_hotel:"	"ğŸ©" 
":convenience_store:"	"ğŸª" 
":school:"	"ğŸ«" 
":department_store:"	"ğŸ¬" 
":factory:"	"ğŸ­" 
":japanese_castle:"	"ğŸ¯" 
":castle:"	"ğŸ°" 
":wedding:"	"ğŸ’’" 
":tokyo_tower:"	"ğŸ—¼" 
":statue_of_liberty:"	"ğŸ—½" 
":church:"	"â›ª" 
":mosque:"	"ğŸ•Œ" 
":hindu_temple:"	"ğŸ›•" 
":synagogue:"	"ğŸ•" 
":shinto_shrine:"	"â›©" 
":kaaba:"	"ğŸ•‹" 
":fountain:"	"â›²" 
":tent:"	"â›º" 
":foggy:"	"ğŸŒ" 
":night_with_stars:"	"ğŸŒƒ" 
":cityscape:"	"ğŸ™" 
":sunrise_over_mountains:"	"ğŸŒ„" 
":sunrise:"	"ğŸŒ…" 
":cityscape_at_dusk:"	"ğŸŒ†" 
":sunset:"	"ğŸŒ‡" 
":bridge_at_night:"	"ğŸŒ‰" 
":hot_springs:"	"â™¨" 
":carousel_horse:"	"ğŸ " 
":ferris_wheel:"	"ğŸ¡" 
":roller_coaster:"	"ğŸ¢" 
":barber_pole:"	"ğŸ’ˆ" 
":circus_tent:"	"ğŸª" 
":locomotive:"	"ğŸš‚" 
":railway_car:"	"ğŸšƒ" 
":high_speed_train:"	"ğŸš„" 
":bullet_train:"	"ğŸš…" 
":train2:"	"ğŸš†" 
":metro:"	"ğŸš‡" 
":light_rail:"	"ğŸšˆ" 
":station:"	"ğŸš‰" 
":tram:"	"ğŸšŠ" 
":monorail:"	"ğŸš" 
":mountain_railway:"	"ğŸš" 
":train:"	"ğŸš‹" 
":bus:"	"ğŸšŒ" 
":oncoming_bus:"	"ğŸš" 
":trolleybus:"	"ğŸš" 
":minibus:"	"ğŸš" 
":ambulance:"	"ğŸš‘" 
":fire_engine:"	"ğŸš’" 
":police_car:"	"ğŸš“" 
":oncoming_police_car:"	"ğŸš”" 
":taxi:"	"ğŸš•" 
":oncoming_taxi:"	"ğŸš–" 
":automobile:"	"ğŸš—" 
":oncoming_automobile:"	"ğŸš˜" 
":sport_utility_vehicle:"	"ğŸš™" 
":pickup_truck:"	"ğŸ›»" 
":delivery_truck:"	"ğŸšš" 
":articulated_lorry:"	"ğŸš›" 
":tractor:"	"ğŸšœ" 
":racing_car:"	"ğŸ" 
":motorcycle:"	"ğŸ" 
":motor_scooter:"	"ğŸ›µ" 
":manual_wheelchair:"	"ğŸ¦½" 
":motorized_wheelchair:"	"ğŸ¦¼" 
":auto_rickshaw:"	"ğŸ›º" 
":bicycle:"	"ğŸš²" 
":kick_scooter:"	"ğŸ›´" 
":skateboard:"	"ğŸ›¹" 
":roller_skate:"	"ğŸ›¼" 
":bus_stop:"	"ğŸš" 
":motorway:"	"ğŸ›£" 
":railway_track:"	"ğŸ›¤" 
":oil_drum:"	"ğŸ›¢" 
":fuel_pump:"	"â›½" 
":police_car_light:"	"ğŸš¨" 
":horizontal_traffic_light:"	"ğŸš¥" 
":vertical_traffic_light:"	"ğŸš¦" 
":stop_sign:"	"ğŸ›‘" 
":construction:"	"ğŸš§" 
":anchor:"	"âš“" 
":sailboat:"	"â›µ" 
":canoe:"	"ğŸ›¶" 
":speedboat:"	"ğŸš¤" 
":passenger_ship:"	"ğŸ›³" 
":ferry:"	"â›´" 
":motor_boat:"	"ğŸ›¥" 
":ship:"	"ğŸš¢" 
":airplane:"	"âœˆ" 
":small_airplane:"	"ğŸ›©" 
":airplane_departure:"	"ğŸ›«" 
":airplane_arrival:"	"ğŸ›¬" 
":parachute:"	"ğŸª‚" 
":seat:"	"ğŸ’º" 
":helicopter:"	"ğŸš" 
":suspension_railway:"	"ğŸšŸ" 
":mountain_cableway:"	"ğŸš " 
":aerial_tramway:"	"ğŸš¡" 
":satellite:"	"ğŸ›°" 
":rocket:"	"ğŸš€" 
":flying_saucer:"	"ğŸ›¸" 
":bellhop_bell:"	"ğŸ›" 
":luggage:"	"ğŸ§³" 
":hourglass_done:"	"âŒ›" 
":hourglass_not_done:"	"â³" 
":watch:"	"âŒš" 
":alarm_clock:"	"â°" 
":stopwatch:"	"â±" 
":timer_clock:"	"â²" 
":mantelpiece_clock:"	"ğŸ•°" 
":twelve_oâ€™clock:"	"ğŸ•›" 
":twelve_thirty:"	"ğŸ•§" 
":one_oâ€™clock:"	"ğŸ•" 
":one_thirty:"	"ğŸ•œ" 
":two_oâ€™clock:"	"ğŸ•‘" 
":two_thirty:"	"ğŸ•" 
":three_oâ€™clock:"	"ğŸ•’" 
":three_thirty:"	"ğŸ•" 
":four_oâ€™clock:"	"ğŸ•“" 
":four_thirty:"	"ğŸ•Ÿ" 
":five_oâ€™clock:"	"ğŸ•”" 
":five_thirty:"	"ğŸ• " 
":six_oâ€™clock:"	"ğŸ••" 
":six_thirty:"	"ğŸ•¡" 
":seven_oâ€™clock:"	"ğŸ•–" 
":seven_thirty:"	"ğŸ•¢" 
":eight_oâ€™clock:"	"ğŸ•—" 
":eight_thirty:"	"ğŸ•£" 
":nine_oâ€™clock:"	"ğŸ•˜" 
":nine_thirty:"	"ğŸ•¤" 
":ten_oâ€™clock:"	"ğŸ•™" 
":ten_thirty:"	"ğŸ•¥" 
":eleven_oâ€™clock:"	"ğŸ•š" 
":eleven_thirty:"	"ğŸ•¦" 
":new_moon:"	"ğŸŒ‘" 
":waxing_crescent_moon:"	"ğŸŒ’" 
":first_quarter_moon:"	"ğŸŒ“" 
":waxing_gibbous_moon:"	"ğŸŒ”" 
":full_moon:"	"ğŸŒ•" 
":waning_gibbous_moon:"	"ğŸŒ–" 
":last_quarter_moon:"	"ğŸŒ—" 
":waning_crescent_moon:"	"ğŸŒ˜" 
":crescent_moon:"	"ğŸŒ™" 
":new_moon_face:"	"ğŸŒš" 
":first_quarter_moon_face:"	"ğŸŒ›" 
":last_quarter_moon_face:"	"ğŸŒœ" 
":thermometer:"	"ğŸŒ¡" 
":sun:"	"â˜€" 
":full_moon_face:"	"ğŸŒ" 
":sun_with_face:"	"ğŸŒ" 
":ringed_planet:"	"ğŸª" 
":star:"	"â­" 
":glowing_star:"	"ğŸŒŸ" 
":shooting_star:"	"ğŸŒ " 
":milky_way:"	"ğŸŒŒ" 
":cloud:"	"â˜" 
":sun_behind_cloud:"	"â›…" 
":cloud_with_lightning_and_rain:"	"â›ˆ" 
":sun_behind_small_cloud:"	"ğŸŒ¤" 
":sun_behind_large_cloud:"	"ğŸŒ¥" 
":sun_behind_rain_cloud:"	"ğŸŒ¦" 
":cloud_with_rain:"	"ğŸŒ§" 
":cloud_with_snow:"	"ğŸŒ¨" 
":cloud_with_lightning:"	"ğŸŒ©" 
":tornado:"	"ğŸŒª" 
":fog:"	"ğŸŒ«" 
":wind_face:"	"ğŸŒ¬" 
":cyclone:"	"ğŸŒ€" 
":rainbow:"	"ğŸŒˆ" 
":closed_umbrella:"	"ğŸŒ‚" 
":umbrella:"	"â˜‚" 
":umbrella_with_rain_drops:"	"â˜”" 
":umbrella_on_ground:"	"â›±" 
":high_voltage:"	"âš¡" 
":snowflake:"	"â„" 
":snowman:"	"â˜ƒ" 
":snowman_without_snow:"	"â›„" 
":comet:"	"â˜„" 
":fire:"	"ğŸ”¥" 
":droplet:"	"ğŸ’§" 
":water_wave:"	"ğŸŒŠ" 

Category:	Activities
":jack_o_lantern:"	"ğŸƒ" 
":christmas_tree:"	"ğŸ„" 
":fireworks:"	"ğŸ†" 
":sparkler:"	"ğŸ‡" 
":firecracker:"	"ğŸ§¨" 
":sparkles:"	"âœ¨" 
":balloon:"	"ğŸˆ" 
":party_popper:"	"ğŸ‰" 
":confetti_ball:"	"ğŸŠ" 
":tanabata_tree:"	"ğŸ‹" 
":pine_decoration:"	"ğŸ" 
":japanese_dolls:"	"ğŸ" 
":carp_streamer:"	"ğŸ" 
":wind_chime:"	"ğŸ" 
":moon_viewing_ceremony:"	"ğŸ‘" 
":red_envelope:"	"ğŸ§§" 
":ribbon:"	"ğŸ€" 
":wrapped_gift:"	"ğŸ" 
":reminder_ribbon:"	"ğŸ—" 
":admission_tickets:"	"ğŸŸ" 
":ticket:"	"ğŸ«" 
":military_medal:"	"ğŸ–" 
":trophy:"	"ğŸ†" 
":sports_medal:"	"ğŸ…" 
":1st_place_medal:"	"ğŸ¥‡" 
":2nd_place_medal:"	"ğŸ¥ˆ" 
":3rd_place_medal:"	"ğŸ¥‰" 
":soccer_ball:"	"âš½" 
":baseball:"	"âš¾" 
":softball:"	"ğŸ¥" 
":basketball:"	"ğŸ€" 
":volleyball:"	"ğŸ" 
":american_football:"	"ğŸˆ" 
":rugby_football:"	"ğŸ‰" 
":tennis:"	"ğŸ¾" 
":flying_disc:"	"ğŸ¥" 
":bowling:"	"ğŸ³" 
":cricket_game:"	"ğŸ" 
":field_hockey:"	"ğŸ‘" 
":ice_hockey:"	"ğŸ’" 
":lacrosse:"	"ğŸ¥" 
":ping_pong:"	"ğŸ“" 
":badminton:"	"ğŸ¸" 
":boxing_glove:"	"ğŸ¥Š" 
":martial_arts_uniform:"	"ğŸ¥‹" 
":goal_net:"	"ğŸ¥…" 
":flag_in_hole:"	"â›³" 
":ice_skate:"	"â›¸" 
":fishing_pole:"	"ğŸ£" 
":diving_mask:"	"ğŸ¤¿" 
":running_shirt:"	"ğŸ½" 
":skis:"	"ğŸ¿" 
":sled:"	"ğŸ›·" 
":curling_stone:"	"ğŸ¥Œ" 
":bullseye:"	"ğŸ¯" 
":yo_yo:"	"ğŸª€" 
":kite:"	"ğŸª" 
":pool_8_ball:"	"ğŸ±" 
":crystal_ball:"	"ğŸ”®" 
":magic_wand:"	"ğŸª„" 
":nazar_amulet:"	"ğŸ§¿" 
":video_game:"	"ğŸ®" 
":joystick:"	"ğŸ•¹" 
":slot_machine:"	"ğŸ°" 
":game_die:"	"ğŸ²" 
":puzzle_piece:"	"ğŸ§©" 
":teddy_bear:"	"ğŸ§¸" 
":piÃ±ata:"	"ğŸª…" 
":nesting_dolls:"	"ğŸª†" 
":spade_suit:"	"â™ " 
":heart_suit:"	"â™¥" 
":diamond_suit:"	"â™¦" 
":club_suit:"	"â™£" 
":chess_pawn:"	"â™Ÿ" 
":joker:"	"ğŸƒ" 
":mahjong_red_dragon:"	"ğŸ€„" 
":flower_playing_cards:"	"ğŸ´" 
":performing_arts:"	"ğŸ­" 
":framed_picture:"	"ğŸ–¼" 
":artist_palette:"	"ğŸ¨" 
":thread:"	"ğŸ§µ" 
":sewing_needle:"	"ğŸª¡" 
":yarn:"	"ğŸ§¶" 
":knot:"	"ğŸª¢" 

Category:	Objects
":glasses:"	"ğŸ‘“" 
":dark_sunglasses:"	"ğŸ•¶" 
":goggles:"	"ğŸ¥½" 
":lab_coat:"	"ğŸ¥¼" 
":safety_vest:"	"ğŸ¦º" 
":necktie:"	"ğŸ‘”" 
":t_shirt:"	"ğŸ‘•" 
":jeans:"	"ğŸ‘–" 
":scarf:"	"ğŸ§£" 
":gloves:"	"ğŸ§¤" 
":coat:"	"ğŸ§¥" 
":socks:"	"ğŸ§¦" 
":dress:"	"ğŸ‘—" 
":kimono:"	"ğŸ‘˜" 
":sari:"	"ğŸ¥»" 
":one_piece_swimsuit:"	"ğŸ©±" 
":briefs:"	"ğŸ©²" 
":shorts:"	"ğŸ©³" 
":bikini:"	"ğŸ‘™" 
":womanâ€™s_clothes:"	"ğŸ‘š" 
":purse:"	"ğŸ‘›" 
":handbag:"	"ğŸ‘œ" 
":clutch_bag:"	"ğŸ‘" 
":shopping_bags:"	"ğŸ›" 
":backpack:"	"ğŸ’" 
":thong_sandal:"	"ğŸ©´" 
":manâ€™s_shoe:"	"ğŸ‘" 
":running_shoe:"	"ğŸ‘Ÿ" 
":hiking_boot:"	"ğŸ¥¾" 
":flat_shoe:"	"ğŸ¥¿" 
":high_heeled_shoe:"	"ğŸ‘ " 
":womanâ€™s_sandal:"	"ğŸ‘¡" 
":ballet_shoes:"	"ğŸ©°" 
":womanâ€™s_boot:"	"ğŸ‘¢" 
":crown:"	"ğŸ‘‘" 
":womanâ€™s_hat:"	"ğŸ‘’" 
":top_hat:"	"ğŸ©" 
":graduation_cap:"	"ğŸ“" 
":billed_cap:"	"ğŸ§¢" 
":military_helmet:"	"ğŸª–" 
":rescue_workerâ€™s_helmet:"	"â›‘" 
":prayer_beads:"	"ğŸ“¿" 
":lipstick:"	"ğŸ’„" 
":ring:"	"ğŸ’" 
":gem_stone:"	"ğŸ’" 
":muted_speaker:"	"ğŸ”‡" 
":speaker_low_volume:"	"ğŸ”ˆ" 
":speaker_medium_volume:"	"ğŸ”‰" 
":speaker_high_volume:"	"ğŸ”Š" 
":loudspeaker:"	"ğŸ“¢" 
":megaphone:"	"ğŸ“£" 
":postal_horn:"	"ğŸ“¯" 
":bell:"	"ğŸ””" 
":bell_with_slash:"	"ğŸ”•" 
":musical_score:"	"ğŸ¼" 
":musical_note:"	"ğŸµ" 
":musical_notes:"	"ğŸ¶" 
":studio_microphone:"	"ğŸ™" 
":level_slider:"	"ğŸš" 
":control_knobs:"	"ğŸ›" 
":microphone:"	"ğŸ¤" 
":headphone:"	"ğŸ§" 
":radio:"	"ğŸ“»" 
":saxophone:"	"ğŸ·" 
":accordion:"	"ğŸª—" 
":guitar:"	"ğŸ¸" 
":musical_keyboard:"	"ğŸ¹" 
":trumpet:"	"ğŸº" 
":violin:"	"ğŸ»" 
":banjo:"	"ğŸª•" 
":drum:"	"ğŸ¥" 
":long_drum:"	"ğŸª˜" 
":mobile_phone:"	"ğŸ“±" 
":mobile_phone_with_arrow:"	"ğŸ“²" 
":telephone:"	"â˜" 
":telephone_receiver:"	"ğŸ“" 
":pager:"	"ğŸ“Ÿ" 
":fax_machine:"	"ğŸ“ " 
":battery:"	"ğŸ”‹" 
":electric_plug:"	"ğŸ”Œ" 
":laptop:"	"ğŸ’»" 
":desktop_computer:"	"ğŸ–¥" 
":printer:"	"ğŸ–¨" 
":keyboard:"	"âŒ¨" 
":computer_mouse:"	"ğŸ–±" 
":trackball:"	"ğŸ–²" 
":computer_disk:"	"ğŸ’½" 
":floppy_disk:"	"ğŸ’¾" 
":optical_disk:"	"ğŸ’¿" 
":dvd:"	"ğŸ“€" 
":abacus:"	"ğŸ§®" 
":movie_camera:"	"ğŸ¥" 
":film_frames:"	"ğŸ" 
":film_projector:"	"ğŸ“½" 
":clapper_board:"	"ğŸ¬" 
":television:"	"ğŸ“º" 
":camera:"	"ğŸ“·" 
":camera_with_flash:"	"ğŸ“¸" 
":video_camera:"	"ğŸ“¹" 
":videocassette:"	"ğŸ“¼" 
":magnifying_glass_tilted_left:"	"ğŸ”" 
":magnifying_glass_tilted_right:"	"ğŸ”" 
":candle:"	"ğŸ•¯" 
":light_bulb:"	"ğŸ’¡" 
":flashlight:"	"ğŸ”¦" 
":red_paper_lantern:"	"ğŸ®" 
":diya_lamp:"	"ğŸª”" 
":notebook_with_decorative_cover:"	"ğŸ“”" 
":closed_book:"	"ğŸ“•" 
":open_book:"	"ğŸ“–" 
":green_book:"	"ğŸ“—" 
":blue_book:"	"ğŸ“˜" 
":orange_book:"	"ğŸ“™" 
":books:"	"ğŸ“š" 
":notebook:"	"ğŸ““" 
":ledger:"	"ğŸ“’" 
":page_with_curl:"	"ğŸ“ƒ" 
":scroll:"	"ğŸ“œ" 
":page_facing_up:"	"ğŸ“„" 
":newspaper:"	"ğŸ“°" 
":rolled_up_newspaper:"	"ğŸ—" 
":bookmark_tabs:"	"ğŸ“‘" 
":bookmark:"	"ğŸ”–" 
":label:"	"ğŸ·" 
":money_bag:"	"ğŸ’°" 
":coin:"	"ğŸª™" 
":yen_banknote:"	"ğŸ’´" 
":dollar_banknote:"	"ğŸ’µ" 
":euro_banknote:"	"ğŸ’¶" 
":pound_banknote:"	"ğŸ’·" 
":money_with_wings:"	"ğŸ’¸" 
":credit_card:"	"ğŸ’³" 
":receipt:"	"ğŸ§¾" 
":chart_increasing_with_yen:"	"ğŸ’¹" 
":envelope:"	"âœ‰" 
":e_mail:"	"ğŸ“§" 
":incoming_envelope:"	"ğŸ“¨" 
":envelope_with_arrow:"	"ğŸ“©" 
":outbox_tray:"	"ğŸ“¤" 
":inbox_tray:"	"ğŸ“¥" 
":package:"	"ğŸ“¦" 
":closed_mailbox_with_raised_flag:"	"ğŸ“«" 
":closed_mailbox_with_lowered_flag:"	"ğŸ“ª" 
":open_mailbox_with_raised_flag:"	"ğŸ“¬" 
":open_mailbox_with_lowered_flag:"	"ğŸ“­" 
":postbox:"	"ğŸ“®" 
":ballot_box_with_ballot:"	"ğŸ—³" 
":pencil2:"	"âœ" 
":black_nib:"	"âœ’" 
":fountain_pen:"	"ğŸ–‹" 
":pen:"	"ğŸ–Š" 
":paintbrush:"	"ğŸ–Œ" 
":crayon:"	"ğŸ–" 
":memo:"	"ğŸ“" 
":briefcase:"	"ğŸ’¼" 
":file_folder:"	"ğŸ“" 
":open_file_folder:"	"ğŸ“‚" 
":card_index_dividers:"	"ğŸ—‚" 
":date:"	"ğŸ“…" 
":calendar:"	"ğŸ“†" 
":spiral_notepad:"	"ğŸ—’" 
":spiral_calendar:"	"ğŸ—“" 
":card_index:"	"ğŸ“‡" 
":chart_increasing:"	"ğŸ“ˆ" 
":chart_decreasing:"	"ğŸ“‰" 
":bar_chart:"	"ğŸ“Š" 
":clipboard:"	"ğŸ“‹" 
":pushpin:"	"ğŸ“Œ" 
":round_pushpin:"	"ğŸ“" 
":paperclip:"	"ğŸ“" 
":linked_paperclips:"	"ğŸ–‡" 
":straight_ruler:"	"ğŸ“" 
":triangular_ruler:"	"ğŸ“" 
":scissors:"	"âœ‚" 
":card_file_box:"	"ğŸ—ƒ" 
":file_cabinet:"	"ğŸ—„" 
":wastebasket:"	"ğŸ—‘" 
":locked:"	"ğŸ”’" 
":unlocked:"	"ğŸ”“" 
":locked_with_pen:"	"ğŸ”" 
":locked_with_key:"	"ğŸ”" 
":key:"	"ğŸ”‘" 
":old_key:"	"ğŸ—" 
":hammer:"	"ğŸ”¨" 
":axe:"	"ğŸª“" 
":pick:"	"â›" 
":hammer_and_pick:"	"âš’" 
":hammer_and_wrench:"	"ğŸ› " 
":dagger:"	"ğŸ—¡" 
":crossed_swords:"	"âš”" 
":water_pistol:"	"ğŸ”«" 
":boomerang:"	"ğŸªƒ" 
":bow_and_arrow:"	"ğŸ¹" 
":shield:"	"ğŸ›¡" 
":carpentry_saw:"	"ğŸªš" 
":wrench:"	"ğŸ”§" 
":screwdriver:"	"ğŸª›" 
":nut_and_bolt:"	"ğŸ”©" 
":gear:"	"âš™" 
":clamp:"	"ğŸ—œ" 
":balance_scale:"	"âš–" 
":white_cane:"	"ğŸ¦¯" 
":link:"	"ğŸ”—" 
":chains:"	"â›“" 
":hook:"	"ğŸª" 
":toolbox:"	"ğŸ§°" 
":magnet:"	"ğŸ§²" 
":ladder:"	"ğŸªœ" 
":alembic:"	"âš—" 
":test_tube:"	"ğŸ§ª" 
":petri_dish:"	"ğŸ§«" 
":dna:"	"ğŸ§¬" 
":microscope:"	"ğŸ”¬" 
":telescope:"	"ğŸ”­" 
":satellite_antenna:"	"ğŸ“¡" 
":syringe:"	"ğŸ’‰" 
":drop_of_blood:"	"ğŸ©¸" 
":pill:"	"ğŸ’Š" 
":adhesive_bandage:"	"ğŸ©¹" 
":stethoscope:"	"ğŸ©º" 
":door:"	"ğŸšª" 
":elevator:"	"ğŸ›—" 
":mirror:"	"ğŸª" 
":window:"	"ğŸªŸ" 
":bed:"	"ğŸ›" 
":couch_and_lamp:"	"ğŸ›‹" 
":chair:"	"ğŸª‘" 
":toilet:"	"ğŸš½" 
":plunger:"	"ğŸª " 
":shower:"	"ğŸš¿" 
":bathtub:"	"ğŸ›" 
":mouse_trap:"	"ğŸª¤" 
":razor:"	"ğŸª’" 
":lotion_bottle:"	"ğŸ§´" 
":safety_pin:"	"ğŸ§·" 
":broom:"	"ğŸ§¹" 
":basket:"	"ğŸ§º" 
":roll_of_paper:"	"ğŸ§»" 
":bucket:"	"ğŸª£" 
":soap:"	"ğŸ§¼" 
":toothbrush:"	"ğŸª¥" 
":sponge:"	"ğŸ§½" 
":fire_extinguisher:"	"ğŸ§¯" 
":shopping_cart:"	"ğŸ›’" 
":cigarette:"	"ğŸš¬" 
":coffin:"	"âš°" 
":headstone:"	"ğŸª¦" 
":funeral_urn:"	"âš±" 
":moai:"	"ğŸ—¿" 
":placard:"	"ğŸª§" 

Category:	Symbols
":atm_sign:"	"ğŸ§" 
":litter_in_bin_sign:"	"ğŸš®" 
":potable_water:"	"ğŸš°" 
":wheelchair_symbol:"	"â™¿" 
":menâ€™s_room:"	"ğŸš¹" 
":womenâ€™s_room:"	"ğŸšº" 
":restroom:"	"ğŸš»" 
":baby_symbol:"	"ğŸš¼" 
":water_closet:"	"ğŸš¾" 
":passport_control:"	"ğŸ›‚" 
":customs:"	"ğŸ›ƒ" 
":baggage_claim:"	"ğŸ›„" 
":left_luggage:"	"ğŸ›…" 
":warning:"	"âš " 
":children_crossing:"	"ğŸš¸" 
":no_entry:"	"â›”" 
":prohibited:"	"ğŸš«" 
":no_bicycles:"	"ğŸš³" 
":no_smoking:"	"ğŸš­" 
":no_littering:"	"ğŸš¯" 
":non_potable_water:"	"ğŸš±" 
":no_pedestrians:"	"ğŸš·" 
":no_mobile_phones:"	"ğŸ“µ" 
":no_one_under_eighteen:"	"ğŸ”" 
":radioactive:"	"â˜¢" 
":biohazard:"	"â˜£" 
":up_arrow:"	"â¬†" 
":up_right_arrow:"	"â†—" 
":right_arrow:"	"â¡" 
":down_right_arrow:"	"â†˜" 
":down_arrow:"	"â¬‡" 
":down_left_arrow:"	"â†™" 
":left_arrow:"	"â¬…" 
":up_left_arrow:"	"â†–" 
":up_down_arrow:"	"â†•" 
":left_right_arrow:"	"â†”" 
":right_arrow_curving_left:"	"â†©" 
":left_arrow_curving_right:"	"â†ª" 
":right_arrow_curving_up:"	"â¤´" 
":right_arrow_curving_down:"	"â¤µ" 
":clockwise_vertical_arrows:"	"ğŸ”ƒ" 
":counterclockwise_arrows_button:"	"ğŸ”„" 
":back_arrow:"	"ğŸ”™" 
":end_arrow:"	"ğŸ”š" 
":on!_arrow:"	"ğŸ”›" 
":soon_arrow:"	"ğŸ”œ" 
":top_arrow:"	"ğŸ”" 
":place_of_worship:"	"ğŸ›" 
":atom_symbol:"	"âš›" 
":om:"	"ğŸ•‰" 
":star_of_david:"	"âœ¡" 
":wheel_of_dharma:"	"â˜¸" 
":yin_yang:"	"â˜¯" 
":latin_cross:"	"âœ" 
":orthodox_cross:"	"â˜¦" 
":star_and_crescent:"	"â˜ª" 
":peace_symbol:"	"â˜®" 
":menorah:"	"ğŸ•" 
":dotted_six_pointed_star:"	"ğŸ”¯" 
":aries:"	"â™ˆ" 
":taurus:"	"â™‰" 
":gemini:"	"â™Š" 
":cancer:"	"â™‹" 
":leo:"	"â™Œ" 
":virgo:"	"â™" 
":libra:"	"â™" 
":scorpio:"	"â™" 
":sagittarius:"	"â™" 
":capricorn:"	"â™‘" 
":aquarius:"	"â™’" 
":pisces:"	"â™“" 
":ophiuchus:"	"â›" 
":shuffle_tracks_button:"	"ğŸ”€" 
":repeat_button:"	"ğŸ”" 
":repeat_single_button:"	"ğŸ”‚" 
":play_button:"	"â–¶" 
":fast_forward_button:"	"â©" 
":next_track_button:"	"â­" 
":play_or_pause_button:"	"â¯" 
":reverse_button:"	"â—€" 
":fast_reverse_button:"	"âª" 
":last_track_button:"	"â®" 
":upwards_button:"	"ğŸ”¼" 
":fast_up_button:"	"â«" 
":downwards_button:"	"ğŸ”½" 
":fast_down_button:"	"â¬" 
":pause_button:"	"â¸" 
":stop_button:"	"â¹" 
":record_button:"	"âº" 
":eject_button:"	"â" 
":cinema:"	"ğŸ¦" 
":dim_button:"	"ğŸ”…" 
":bright_button:"	"ğŸ”†" 
":antenna_bars:"	"ğŸ“¶" 
":vibration_mode:"	"ğŸ“³" 
":mobile_phone_off:"	"ğŸ“´" 
":female_sign:"	"â™€" 
":male_sign:"	"â™‚" 
":transgender_symbol:"	"âš§" 
":multiply:"	"âœ–" 
":plus:"	"â•" 
":minus:"	"â–" 
":divide:"	"â—" 
":infinity:"	"â™¾" 
":double_exclamation_mark:"	"â€¼" 
":exclamation_question_mark:"	"â‰" 
":red_question_mark:"	"â“" 
":white_question_mark:"	"â”" 
":white_exclamation_mark:"	"â•" 
":red_exclamation_mark:"	"â—" 
":wavy_dash:"	"ã€°" 
":currency_exchange:"	"ğŸ’±" 
":heavy_dollar_sign:"	"ğŸ’²" 
":medical_symbol:"	"âš•" 
":recycling_symbol:"	"â™»" 
":fleur_de_lis:"	"âšœ" 
":trident_emblem:"	"ğŸ”±" 
":name_badge:"	"ğŸ“›" 
":japanese_symbol_for_beginner:"	"ğŸ”°" 
":hollow_red_circle:"	"â­•" 
":check_mark_button:"	"âœ…" 
":check_box_with_check:"	"â˜‘" 
":check_mark:"	"âœ”" 
":cross_mark:"	"âŒ" 
":cross_mark_button:"	"â" 
":curly_loop:"	"â°" 
":double_curly_loop:"	"â¿" 
":part_alternation_mark:"	"ã€½" 
":eight_spoked_asterisk:"	"âœ³" 
":eight_pointed_star:"	"âœ´" 
":sparkle:"	"â‡" 
":copyright:"	"Â©" 
":registered:"	"Â®" 
":trade_mark:"	"â„¢" 
":red_circle:"	"ğŸ”´" 
":orange_circle:"	"ğŸŸ " 
":yellow_circle:"	"ğŸŸ¡" 
":green_circle:"	"ğŸŸ¢" 
":blue_circle:"	"ğŸ”µ" 
":purple_circle:"	"ğŸŸ£" 
":brown_circle:"	"ğŸŸ¤" 
":black_circle:"	"âš«" 
":white_circle:"	"âšª" 
":red_square:"	"ğŸŸ¥" 
":orange_square:"	"ğŸŸ§" 
":yellow_square:"	"ğŸŸ¨" 
":green_square:"	"ğŸŸ©" 
":blue_square:"	"ğŸŸ¦" 
":purple_square:"	"ğŸŸª" 
":brown_square:"	"ğŸŸ«" 
":black_large_square:"	"â¬›" 
":white_large_square:"	"â¬œ" 
":black_medium_square:"	"â—¼" 
":white_medium_square:"	"â—»" 
":black_medium_small_square:"	"â—¾" 
":white_medium_small_square:"	"â—½" 
":black_small_square:"	"â–ª" 
":white_small_square:"	"â–«" 
":large_orange_diamond:"	"ğŸ”¶" 
":large_blue_diamond:"	"ğŸ”·" 
":small_orange_diamond:"	"ğŸ”¸" 
":small_blue_diamond:"	"ğŸ”¹" 
":red_triangle_pointed_up:"	"ğŸ”º" 
":red_triangle_pointed_down:"	"ğŸ”»" 
":diamond_with_a_dot:"	"ğŸ’ " 
":radio_button:"	"ğŸ”˜" 
":white_square_button:"	"ğŸ”³" 
":black_square_button:"	"ğŸ”²" 
":chequered_flag:"	"ğŸ" 
":triangular_flag:"	"ğŸš©" 
":crossed_flags:"	"ğŸŒ" 
":black_flag:"	"ğŸ´" 
":white_flag:"	"ğŸ³" 
":rainbow_flag:"	"ğŸ³â€ğŸŒˆ" 
":transgender_flag:"	"ğŸ³â€âš§" 
":pirate_flag:"	"ğŸ´â€â˜ " 
